prediction	ground_truth
अंक	ank	ank
अंकित	ankit	ankit
अंकों	ankon	ankon
अंकोर	ancor	ankor
अंगारक	angarak	angarak
अंग्रज़ी	angrazi	angraji
अंतः	antah	antah
अंतर्मुख	antarmukh	antarmukh
अंद्राबी	andrabi	andrabi
अंधा	andha	andha
अंधापन	andhapan	andhapan
अंधेरी	andheri	andheri
अंबानी	ambani	ambani
अकरम	akaram	akram
अकापुल्को	akapulko	akapulko
अखंड	akhand	akhand
अखिल	akhil	akhil
अगवाई	agavai	agavai
अगस्टाइन	agsutin	augustine
अगस्ता	agasta	agusta
अग्र	agra	agr
अचंभा	achambha	achambha
अचीवमेंट	achivement	achievement
अच्छी	achhi	acchi
अच्युत	achyut	achyut
अछनेरा	acchnera	achhanera
अजमीढ़	ajmidh	ajmeedh
अजहर	ajjhar	azhar
अजित	ajit	ajit
अज्ञात	agyat	agnat
अटकता	atakta	atakta
अटके	atke	atke
अटवाल	atwal	atwal
अट्टहास	atthas	attahasa
अड्डों	addon	addon
अथक	athak	athak
अथर्व	atharv	atharv
अदद	adad	adad
अदाणी	adani	adani
अद्वैत	advat	advait
अद्वैतवाद	advaivad	advaitwad
अधिवास	adhivas	adhivas
अधीक	adhik	adhik
अध्ययनरत	adhyayanatan	adhyayanarat
अनंत	anant	anant
अनंती	ananti	ananti
अनगढ़	angadh	angadh
अनचाहे	anchahe	anchahe
अनथक	anthak	anthak
अनहोनी	anhaoni	anhoni
अनावश्यक	anavashyak	anavashyak
अनिक	anik	anik
अनीश्वरवादी	anishwarwadi	anishwarwadi
अनुकूलता	anukulata	anukoltha
अनुचित	anuchit	anuchit
अनुप्रयोगों	anupryyogon	anuprayogi
अनुरीत	anurit	anureet
अनूठी	anuthi	anuthi
अनूदित	anudit	anudit
अन्याय	anyay	anyaay
अपनानी	apnani	apnani
अपरिवर्तनशील	aparivartanshel	aparivartanshali
अपरिहार्य	aparihyary	apariharya
अपवर्तित	apvartit	apavartit
अपारदर्शी	apardarshi	apardarshi
अफरोज	afraje	afroj
अफ्रीका	afrika	africa
अब्बासी	abbasi	abbasi
अभिमत	abhimat	abhimat
अभिशाप	abhishap	abhishap
अभी	abhi	abhi
अमझेरा	amjhera	amjhera
अमरगढ़	amargarh	amargarh
अमरपाल	amarpal	amarpal
अमरोही	amarhhi	amrohi
अमानत	amanat	amanat
अमानती	amanati	amanati
अमावस्या	amavasya	amavasya
अमित	amit	amit
अमिताव	amitav	amitav
अमुक	amuk	amuk
अमोघ	amogh	amogh
अम्बानी	ambani	ambani
अयोध्यानाथ	ayodhyanath	ayodhyanath
अरदास	ardas	ardas
अरबाब	arbab	arbab
अराउंड	around	around
अर्जेंट	argent	urgent
अर्थ	arth	arth
अर्थक्वेक	arthqvek	earthquake
अर्थों	arthon	arthon
अर्पित	arpit	arpit
अर्यमा	aryama	arymaa
अलंकार	alankar	alankar
अलंकारों	alankaron	alankaaron
अलगाववादी	algavwadi	alagavavadi
अलाइव	alive	alive
अलायंस	alains	alance
अलिंद	alind	alind
अली	ali	ali
अलोंसो	alonso	alonso
अल्फ़ाबेट	alfbabet	alphabet
अल्बा	alba	alba
अवंतिपुर	avantipur	avantipur
अवरु	avaru	avaru
अवरोधक	avarodhak	avarodhak
अवर्णता	avarnata	avarnata
अवशिष्ट	avashisht	avshisht
अवस्थाएं	avasthayen	avasthaayen
अवि	avi	avi
अविका	avika	avika
अविरल	aviral	aviral
अविश्वसनीय	avishwasnni	avishvaasniy
अवीवा	aviva	aviva
अवैज्ञानिक	avagyganik	avaigyanic
अशक्तता	ashakta	ashaktataa
अशरफी	asharfi	ashrafi
अशरीरी	ashriri	ashriri
अश्वत्थ	ashwatth	ashvtth
असमान्य	asmanya	asamany
असामंजस्य	asamanjasya	asamanjasy
असुरक्षित	asurashit	asurakshit
असेट	asste	asset
अस्वभाविक	aswabhavik	asvabhavik
अहिरौली	ahirali	ahirauli
आइटम	itt	item
आइटम्स	ittoms	items
आइडल	idel	idle
आइसीसी	icc	icc
आइसो	ic	iso
आईपीसी	ipc	ipc
आईपैड	ipaad	ipad
आईरिस	irris	iris
आउंस	ounc	ounce
आकाश	aakash	aakash
आके	aake	aake
आखेट	akhet	aakhet
आगत	aagat	aagat
आगमन	aagman	aagman
आग़ा	aaga	aagaa
आगाशे	aaashe	aagaashe
आजमाना	aajmana	aajmana
आटा	aata	aata
आत्माएं	aammayen	aatmayen
आदान	aadan	aadaan
आधारित	aaharit	aadhaarit
आधीन	adhin	aadhin
आधुनिक	aadhunik	aadhunik
आनद	aand	aanad
आपका	aapka	aapka
आपदाएं	aapdaeen	aapadaaaen
आबंटित	aabantit	aabantit
आबरू	aabaru	aabru
आमदन	aamdan	aamdan
आमदनी	aamdani	aamdani
आमदी	aamdi	aamdi
आमोद	aamod	amod
आयेंगे	ayeegge	aayenge
आयोजक	ayojak	aayojak
आरओ	aaro	ro
आरपी	rap	rp
आराम	aram	aaram
आरुषि	aarushi	aarushi
आर्टरी	artyry	artery
आर्डर	arder	order
आर्य	ary	arya
आर्यिका	aryika	aryika
आर्यो	aryo	aarya
आर्यों	aayron	aaryan
आलसी	aalsi	aalsi
आलोचक	aalochak	aalochak
आलोचकों	aalochakon	aalochakon
आल्हा	aahha	aalha
आवाज़ें	aavaajen	aawaazen
आवाज़ों	aavaajon	aawajon
आविष्कार	avishkar	aavishkaar
आवृत्ति	avritti	aavriti
आवृत्तियों	avrittiyon	aavritiyon
आशंका	aashanka	aashanka
आश्रितों	aashriton	aashriton
आसान	aasan	aasan
आस्तिक	aattik	astik
आस्तीन	aattin	aasteen
आह्नान	aannaan	aahnaan
इंग्लैंड	ingland	england
इंजिनियर	enginer	engineer
इंट्रोडक्शन	introduction	introduction
इंश्योरेंस	inshorenss	insurance
इअर	iar	ear
इआन	ian	eon
इकट्ठा	ikattha	ekattha
इकठ्ठी	ikathti	ekatthi
इकाई	ikai	ikai
इकाईयों	ikaiyon	ekaeyon
इकोनोमिक	economic	economic
इक्वाडोर	equddor	ecuador
इक्विटीज	eqvitis	equities
इजाजत	ijajat	ijaajat
इनहेलेशन	inhalation	inhalation
इबीजा	ebija	ibija
इमेजिंग	emmgingg	imaging
इम्युन	immun	immune
इलाइची	ilacchi	elaichi
इलाज	ilaj	ilaaj
इशाक	ishak	ishaak
इशारा	ishara	ishaara
इशिता	ishita	ishita
इष्ट	isht	isht
इस्तीफे	istife	istife
ईए	aaa	ea
ईटर	eter	eater
ईमेल	emal	email
ईमेलों	emelon	emailon
ईवनिंग	evnning	evening
ईष्ट	isht	east
ईसाइयों	isaiyon	isaaiyon
उखरुल	ukhrul	ikhrul
उछालने	ucchhalane	uchhalne
उज़्बेक	ujbek	uzbek
उठने	uthten	uthne
उठाकर	uthakar	uthakar
उठापटक	uthapakak	uthapatak
उठें	uthen	uthen
उड़ान	udan	udaan
उड़ाना	udana	udana
उड़ाने	udane	udaane
उड़ानें	udanen	udanen
उड़ानों	udanon	udanon
उतने	utne	utane
उत्तरा	uttara	uttra
उत्पन	utpan	utpan
उदंत	udant	udant
उदघोष	udghosh	udghosh
उदर	udar	udar
उदा	uda	uda
उदाकिशुनगंज	udakishnnajj	udakishunganj
उनतीस	untis	untees
उनियाल	uniyal	uniyal
उपद्रवियों	updardaviyon	upadraviyon
उपद्रवी	updardavi	updravi
उपद्रवों	updardaaon	upadrawon
उपनेता	upneta	upneta
उपभोक्ता	upbhokta	upbhokta
उपलक्ष्य	uplakshya	uplaksh
उपलब्ध	uplabdh	uplabdh
उपलब्धियों	uplabdhiyon	uplabdhiyon
उपलब्धी	uplabdhi	uplabdhi
उपाख्यानों	upakhyanon	upakhyanon
उबंटू	ubantu	ubuntu
उबाल	ubal	ubal
उभारा	ubhara	ubhara
उमानाथ	umanath	umanath
उमेश	umesh	umesh
उर्फ	urf	urf
उर्वरकों	urvarakon	urvarakon
उर्वरता	urvarta	urvarata
उलटे	ulte	ulte
उलाहना	ulahna	ulahna
उलेमा	ulema	ulema
उलेमाओं	ulemaoon	ulemaon
उसक	usak	usak
उसकी	usaki	uski
उसमें	usman	usmein
उसी	usi	usi
उस्तरा	ustara	ustara
ऊर्ध्व	urdhva	udharv
ऊष्मा	ushma	ushma
ऋषिकुल	rushikul	rishicool
एंजाइम	angimm	enzyme
एंटोन	anton	anton
एंटोनी	antoni	antony
एंडोमेट्रियल	andomatral	endometrial
एंड्रियास	andriyas	andreas
एएलएस	asl	als
एएसआई	aii	asi
एकसाथ	eksath	eksaath
एकाकी	ekkki	ekaki
एक्सएम	acm	xm
एगमोर	agmor	egmore
एजे	age	aj
एजेंडे	agende	agende
एडीपी	adp	adp
एडेन	aden	adain
एड्डी	addy	addi
एपीजे	apg	apj
एफटीआईआई	fiti	ftii
एबट	abt	abbott
एबीवीपी	abbv	abvp
एबोट	abot	abbott
एमटीए	mmt	mta
एमटेक	amtek	mtake
एमरल्ड	amardd	emerald
एमिल	amil	emil
एमी	m	amy
एयरवे	airway	airway
एरर	arr	error
एरिका	erica	arica
एरोबिक	arobic	aerobic
एलटीई	llt	lti
एलर्जिक	alergic	allergic
एलिमिनेटर	aliminator	eliminator
एलियंस	allins	alliance
एशियन	assion	asian
एसएफसी	sccc	sfc
एसके	ss	sk
एसपीएफ	spp	spf
एसोसिएशन	association	association
एस्टर	aster	astar
एस्थेटिक	asthtitic	asthetic
एस्फाल्ट	asphalt	asfalt
एहसास	ahsass	ahsaas
एेसा	asa	aisa
ऐंठ	aith	ainth
ऐंठे	anthne	enthe
ऐठन	aathan	aithan
ऐल	ail	ail
ऐल्प्स	alps	alaps
ऐसे	aise	aise
ऑक्साइड	oxided	oxide
ऑक्सी	oxy	oxy
ऑफर्स	offers	offers
ऑफशोर	offhor	offshore
ऑफिशियल	official	official
ओकलाहोमा	oklahoma	oklahoma
ओक्लाहोमा	oclahoma	oklahoma
ओत	ot	ot
ओपेल	opel	opel
ओब्रायन	obraan	obrayan
ओरण	oran	oran
ओरियन	orian	orion
ओलावृष्टि	olavrishi	olavrishti
ओवम	ovam	ovum
ओशनिक	oshnik	oceanic
ओसाका	osaka	osaka
औचित्य	achitya	auchity
औद्योगिकरण	addygikaran	audhyogikaran
औरंगाबाद	arrangabad	aurangabad
औरोरा	arora	aurora
औलख	allkh	aulakh
कंकड़	kankad	kankad
कंकर	kankar	kankar
कंगन	kangan	kangan
कंजंक्शन	conjsncton	conjunction
कंटेम्पररी	contemperari	contemporary
कंठहार	kanthhar	kanthhar
कंपोजर	composer	composer
कंबलों	kambalon	kambalon
कंसलटेंट	conslltent	consultant
कक्कड़	kakkad	kakkad
कच्चे	kachhe	kacche
कटरा	katra	katra
कटलरी	catlerry	cutlery
कटासराज	katasaraj	katasaraj
कठफोड़वे	kathfod	kathfodave
कठोर	kathor	kathor
कणिका	kanika	kanika
कत्थई	katthai	kathai
कनवेंशन	convenshin	convention
कनाल	kanal	kanal
कनिंघम	kaningham	kaningham
कनिष्ठिका	kanishthika	kanishthika
कन्याएं	kanyayen	kanyaayen
कन्वेंशन	convenshon	convention
कन्वोकेशन	convocation	convocation
कप	kap	cup
कपड़ा	kapda	kapda
कपड़ो	kapado	kapdo
कपिंग	kuping	kaping
कपोलकल्पना	kapolkalpana	kapolkalpana
कबड्डी	cobddy	kabaddi
कब्र	kabra	kabr
कब्रें	kabren	kabren
कब्रों	kabron	kabron
कमज़ोर	kamzaro	kamjor
कमतर	kamtar	kamtar
कमलजीत	kamaljit	kamaljeet
कमाऊ	kamau	kamau
कमाते	kamate	kamate
कमेरे	kamere	kamere
करंज	karanj	karanj
करंजिया	karanjiya	karanjiya
करघे	karghe	karghe
करछना	karchana	karchhana
करना	karna	karna
करपात्री	karpatri	karpatri
करम	karam	karam
करूर	karur	karoor
कर्नाटका	karnataa	karnataka
कर्वी	karvi	karvi
कलमें	kalmen	kalmen
कलराज	kalraj	kalraj
कलिका	kalika	kalika
कल्पनाओं	kalpanaon	kalpanaon
कव्वालियों	kavvaliyon	kavvaliyon
कव्वाली	kavvali	kavvali
कष्टों	kashton	kashton
कसरत	kasarat	kasrat
कसारा	kasara	kasara
कसीदा	kasida	kasida
कहने	kahne	kahane
कहलाया	kahlaya	kahlaya
कहानियों	kahaniyon	kahaniyon
क़िले	kile	kile
कांजी	kanji	kanji
कांट	kant	kant
कांति	kanti	kanti
काकू	kaku	kakoo
कागज़	kagaz	kaagaj
काजी	kaji	kaji
काजू	kaju	kaju
कापड़ी	kapadi	kapdi
कामराज	kamraj	kamraj
कामोत्तेजना	kamottejana	kamottejna
कायलाना	kaylana	kaylana
कार्की	karki	karki
कार्तिक	kartik	kartik
कार्यकर्ताओं	karyakartoon	karyakartaon
कार्यभार	karybhar	karybhar
कार्यरत	karyarat	karyrat
कालपी	kalpi	kalpi
कालिका	kalika	kalika
कालीघाट	kalighat	kalighat
काल्डवेल	kaldwel	coldvel
काव	kav	kaav
काश्त	kasht	kasht
कासिम	kasim	kasim
कासिमाबाद	kasimabad	kasimabad
किया	kiya	kiya
किलियन	killiyan	kiliyan
किल्लत	killat	killat
किल्ली	killi	killi
किसानी	kisani	kisani
किसानों	kisanon	kisanon
कीड़े	kide	kide
कीनोट	kinot	kinote
कीरतपुर	kirarpur	kiratpur
कुंडल	kundal	kundal
कुंडलियाँ	kundaliyan	kundaliyan
कुत्ता	kutta	kutta
कुपोषित	kuposhit	kuposhit
कुमाऊ	kumau	kumau
कुमावत	kumawat	kumawat
कुराल	kural	kural
कुर्मी	kurmi	kurmi
कुर्सियों	kursiyon	kursiyon
कुश	kush	kush
कुषाण	kushan	kushaan
कुसुमलता	kusumalta	kusumalataa
कूट	kut	koot
कृतिका	krikika	kritika
केपीओ	kapoo	kpo
कैंटरबरी	canterbery	canterbury
कैंडिडेट	candidat	candidate
कैटरीना	caterne	katrina
कैटलिन	catllen	caitlyn
कैडमियम	cadmimam	cadmium
कैथोलिक	catholic	catholic
कैथोलिकों	catholikon	catholicon
कैपेसिटर	capesitor	capacitor
कैरेट	carret	carat
कैविटी	cavity	cavity
कैवेलरी	cavellory	kaivelari
कॉम्प्लेक्स	complaxes	complex
कोच्चि	kochhi	kochi
कोरिडोर	koridor	corridor
कोरोला	korola	korola
कोलन	kolan	caolan
कोलिंग	colling	calling
कोलोराडो	kolorado	colorado
कौशल	kaushal	kaushal
कौशलता	kaushalata	kaushalata
कौशाम्बी	kaushasmbi	kaushambi
क्यूट	cut	cute
क्यूब	quwe	cube
क्यूबेक	quwak	quebec
क्यूब्स	cuws	cubes
क्रांतियों	krantiyon	krantiyon
क्रिक	krick	cric
क्रिकेट	crecket	cricket
क्रिकेटर	crickttor	cricketer
क्रिकेटिंग	crickting	cricketing
क्रियायोग	kriyayog	kriyayog
क्रिश्चयन	krishhchayan	christian
क्रूगर	crugger	kruger
क्रेग	cragg	craig
क्रैडल	cradal	cradle
क्रोम	crom	chrome
क्लांइट	clantt	client
क्लाक	clack	clock
क्लासें	clasen	classen
क्लासों	clason	classon
क्ले	klay	clay
क्लेरिस	claris	claris
क्वांटिको	quantico	quantico
क्वींस	quince	queens
क्षितिज	kshitij	kshitij
क्षीण	kshin	kshin
क्षेत्रों	ksheton	kshetron
खंडा	khanda	khanda
खचाखच	khachakha	khachakhach
खजराना	khajrana	khajarana
खटकती	khataki	khatakati
खट्टापन	khattapan	khattapan
खत	khat	khat
खनि	khani	khani
खनिक	khanik	khanik
खनिकर्म	khanikarm	khanikarm
खपत	khapat	khapat
खरिया	khariya	khariya
खलनायक	khalnayak	khalnayak
ख़ासकर	khaskar	khaskar
ख़ासतौर	khastaur	khastaur
ख़ैबर	khabber	khaibar
खाएं	khayen	khaein
खाते	khate	khate
खाल	khal	khal
खिंचकर	khinchar	khinchkar
खिलाना	khilana	khilana
खींचकर	khinchkar	khinchkar
खुदा	khuda	khuda
खुदाई	khudai	khudai
खुरपका	khurpaka	khurpaka
खुरासान	khurasan	khurasan
खुशियां	khushiyan	khushiyan
खेने	khene	khene
खैनी	khaini	khaini
खैराती	khairati	khairati
खोईखोई	khoikhoi	khoikhoi
खोया	khoya	khoya
गंगरेल	gungarel	gangrel
गंगाजल	gangajal	gangajal
गंडकी	gandayi	gandki
गंध	gandh	gandh
गए	gaye	gaye
गजरा	gajara	gajra
गडकर	gadkar	gadkar
गणपति	ganpati	ganapati
गतिशील	gatishil	gatishil
गतिशीलता	gatishilta	gatishilata
गदाधर	gadadhar	gadadhar
गम्मत	gammat	gammat
गया	gaya	gaya
गरीबी	garibi	garibi
गर्जना	garjana	garjana
गलगंड	galgand	galgand
गहमागहमी	gahmagamami	gahmagahmi
गांगुली	ganguli	ganguly
गांठ	ganth	ganth
गांठे	ganthe	ganthe
गांठें	ganthen	ganthen
गांठों	ganthn	ganthon
गाएं	gaen	gaen
गाज़ी	gazi	gazi
गाजीपुर	gajipur	gazipur
गायत्री	gayatri	gayatri
गिड़गिड़ाते	gidgidate	gidgidate
गिनते	ginte	ginte
गिरकर	girkar	girkar
गिरजाघर	girjaghar	girjaghar
गिरजाघरों	girjagharon	girjagharon
गिरती	girati	girti
गिरीश	girish	girish
गुआन	guan	guan
गुजार	gujar	gujar
गुजारता	gujarta	gujarta
गुजारते	gujarte	gujarte
गुजारना	gujarna	gujarna
गुजारा	gujara	gujara
गुजारे	gujare	gujare
गुट्टा	gutta	gutta
गुठलीदार	guthtidar	guthalidar
गुदना	gudna	gudna
गुमान	guman	guman
गुलशन	gulshan	gulshan
गूंगा	gunga	gunga
गृहनगर	granhangar	gruhnagar
गैलेक्सियों	galexisiyon	galaxion
गोचर	gochar	gochar
गोदारा	godara	godara
गोपीचंद	gopichand	gopichand
गोमके	gomke	gomke
गोयल	goyal	goyal
गोस्वामी	goswami	goswami
गौमुख	gaumukh	gaumukh
गौमूत्र	gaumutra	gaumutra
ग्रंथियां	granthiyan	granthiyan
ग्रंथियों	granthiyon	granthiyon
ग्रीस्ट	grest	greest
ग्रेग	gragg	greg
ग्रेनाइट	granite	granite
ग्रैंडसन	grandson	grandson
ग्रॉस	gross	gross
घटाटोप	ghatatop	ghatatop
घटाया	ghataya	ghataya
घनाकार	ghanakar	ghanakar
घबराहट	ghabrahat	ghabrahat
घासी	ghasi	ghasi
घिसाई	ghisai	ghisai
घिसी	ghisi	ghisi
घिसे	ghise	ghise
घुमक्कड़ी	ghumakkadi	ghumakkadi
घुमक्कड़ों	ghumakkadon	ghumakkadon
घुमाण	ghuman	ghuman
घूंसा	ghunsa	ghunsa
घोंघा	ghongha	ghongha
घोंटने	ghontane	ghontane
घोट	ghot	ghot
घोड़ी	ghodi	ghodi
घोस्ट	ghost	ghost
चंगुल	changul	changul
चंद	chand	chand
चंदन	chandan	chandan
चंदू	chandu	chandu
चंदों	chandon	chandon
चंद्रबली	chandrabali	chandrabali
चंद्रमाओं	chandramaon	chandramaon
चकत्ते	chakatt	chaktte
चक्कर	chakkar	chakkar
चक्षु	chakshu	chakshu
चटगांव	chatgaan	chatgaon
चढ़ने	chadhane	chadhne
चतुर्दिक	chaturdik	chaturdik
चतुष्कोणीय	chatushkoniya	chatunshkoniy
चन्ना	channa	channa
चबाते	chabate	chabate
चबूतरे	chabutre	chabutare
चमकना	chamaka	chamakna
चरस	charas	charas
चरित	charit	charit
चर्चा	charcha	charcha
चर्चाओं	charchaon	charchaon
चलेंगे	chalenge	chalenge
चहुंओर	chahunrar	chahunor
चांवल	chanwal	chanval
चाचाजी	chachaji	chachaji
चादर	chadar	chadar
चादरों	chadron	chadron
चान	chan	chan
चानन	chanan	chanan
चापलूसी	chaplussi	chaplusi
चायल	chayal	chayal
चार	char	char
चारों	charon	charon
चार्ज	charg	charge
चार्ट	chart	chart
चार्टों	charton	charton
चार्ट्स	charts	charts
चालित	chalit	chaalit
चिकित्सक	chikitsak	chikitsak
चिकित्सकों	chikitsaon	chikitsakon
चिखली	chikhkli	chikhali
चिट्ठी	chitthi	chitthi
चिठ्ठी	chithti	chithhi
चिडचिडापन	chidchidapan	chidchidapan
चिड़चिड़ापन	chidchidapan	chidchidapan
चिढ़ते	chidhte	chidhate
चित्रकार	chitrkar	chitrkar
चिपकने	chipkane	chipakane
चिमटी	chimati	chimti
चिल्लाने	chillane	chillane
ची	chi	chi
चुका	chuka	chuka
चुने	chune	chune
चूनर	chunnar	chunar
चेंज्ड	changd	changed
चेट्टी	chetty	chetti
चेन्नई	chenni	chennai
चेरो	chero	chero
चेस्ट	chest	chest
चैंपियनशिप	champinaship	championship
चोर	chor	chor
चोरों	choron	choron
चौक	chauk	chauk
चौका	chauka	chauka
चौकियां	chaukiyan	chaukiyan
चौकी	chauki	chauki
चौखटे	chaukhke	chaukhate
चौगुनी	chauguni	chauguni
चौड़ा	chauda	chauda
चौदहवां	chauddhwan	chaudahavan
चौपाटी	chaupati	chaupati
चौपाल	chaupal	chaupal
चौरई	chauri	chaurai
चौसिंगा	chausinga	chausinga
छगन	chhagan	chhagan
छबि	chhabi	chhabi
छल्ला	chhalla	chhalla
छवियाँ	chhaviyan	chhaviyan
छवी	chhavi	chhavi
छह	chhah	chhah
छहों	chhahon	chhahon
छाई	chhai	chhai
छागला	chhagala	chhagla
छाजन	chhajan	chhajan
छाती	chhati	chhati
छापेमार	chhapemar	chhapemar
छींक	chhink	chhink
छींके	chhinke	chenkein
छुडाने	chhudane	chhudane
छुपकर	chhupkar	chhupkar
छुपता	chhupata	chhupta
छुरा	chhura	chhura
छुरी	chhuri	chhuri
छुरे	chhure	chhure
छूटने	chhutane	chhutane
छेत्र	chhetra	chhetr
छेत्री	chhetri	chhetri
छै	chhai	chai
जगाएगा	jagaege	jagaega
जजों	jajon	jajon
जड़	jad	jad
जड़ित	jadit	jadit
जड़ें	jaden	jadein
जतरा	jatara	jatara
जताती	jataati	jatati
जनगणना	janganaa	janganana
जनजागरण	janjagaran	janjagran
जनवरी	janvari	january
जनहानि	janhani	janahaani
जमाती	jamati	jamaati
जमाया	jamaya	jamaya
जमुई	jamui	jamui
जय	jay	jai
जयदयाल	jayddaal	jaydayal
जयबाण	jayban	jaiban
जयललिता	jayallita	jayalalita
जरख	jarakh	jarakh
जर्दा	jarda	jarda
जलगति	jalgati	jalgati
जलते	jalate	jalte
जलभराव	jalbharav	jalbharav
जलवायु	jalwayu	jalvayu
जलेसर	jalasar	jalesar
जसमीत	jasmeet	jasmeet
जस्सी	jassi	jassi
ज़माना	zamana	zamana
ज़लज़ले	jaljale	jaljale
ज़ी	zi	zee
ज़ुबान	juban	jubaan
जाँच	jaanch	janch
जागृति	jagriti	jagriti
जाजमऊ	jajmau	jajamau
जात	jaat	jaat
जातक	jatak	jaatak
जातकों	jaakakon	jatakon
जातियों	jatiyon	jaatiyon
जानकारों	jankaron	jankaron
जानम	janam	jaanam
जायके	jayke	jaayke
जावर	jaarar	zawar
जिंग	ging	jing
जिन	gin	jin
जिनी	jini	jini
जिनीवा	jiniva	geneva
जिप्सी	jipsy	gypsy
जिम्मे	jimme	jimme
जिया	jiya	jiya
जीआईसी	gic	gic
जीआर	gr	gr
जीएम	gm	gm
जीएसएम	gmm	gsm
जीतोड़	jitod	jitod
जीन	jeen	jeen
जीनों	jinon	jeenon
जीपनी	jipani	jipani
जीयो	jiyo	jeeyo
जीरा	jira	jeera
जीवंत	jivant	jivant
जीवन	jivan	jeevan
जीवनशैली	jivanshili	jivanshaili
जीवनियां	jivaniyan	jeevniyaan
जीवराज	jivarraj	jivraj
जुए	juye	jua
जुटी	juti	juti
जुड़ाई	judai	judaai
जुदाई	judai	judaai
जुनून	junun	junoon
जुनूनी	jununi	junooni
जुबेर	juber	juber
जुराब	jurab	jurab
जुलाहों	julahon	julaahon
जुल्मों	julmon	julmon
जूड	judd	jud
जूनागढ	junagadh	junagarh
जूनियर	juniyar	junior
जूलूस	julus	juloos
जेठा	jetha	jetha
जेनर	gainar	jenner
जेनरिक	genric	generic
जेनरेट	gennete	generate
जेनी	jeni	jenny
जेम्स	jeme	james
जेरेमी	jeremi	jeremy
जेरोम	jerom	jerome
जैक्स	jaxk	jacks
जैन	jain	jain
जैने	jaine	jaine
जैनों	jainon	jainon
जैरी	jairy	jerry
जैस्पर	jaisper	jasper
जॉगिंग	joging	jogging
जॉनसन	jonssan	johnson
जॉब्स	jobs	jobs
जोकि	joki	joki
जोखिम	jokhim	jokhim
जोड़ता	jodta	jodta
जोड़ियों	jodiyon	jodiyon
जोड़ो	jodo	jodo
जौं	jaun	jaun
ज्ञातव्य	gyatvay	gyatavya
ज्ञापित	gyapit	gyapit
ज्योतिबा	jyotiba	jyotiba
ज्वाइंट	jeint	joint
ज्वार	jwar	jwar
ज्वारों	jwaron	jvaaron
ज्वेलर्स	jeallers	jewellers
झ	jhj	jh
झलकती	jhalakati	jhalkati
झल्ला	jhalla	jhalla
झांकना	jhankana	jhankana
झील	jheel	jhil
झीलों	jhilon	jhilon
झुठला	jhuthtala	jhuthla
झुठलाने	jhuthtane	jhuthlane
टंकार	tankar	tankar
टकरा	takra	takra
टकरावों	takravon	takravon
टपकती	tapakati	tapakti
टाइम	time	time
टाइमर	timer	timer
टाऊ	tau	tau
टापुओं	tapuon	tapuon
टायर्ड	tire	tied
टार्च	tarch	tarch
टिक	tik	tik
टिप	tip	tip
टिप्पणीकार	tippanikar	tippanikar
टिवोली	tivoli	tivoli
टीकमगढ़	tikamgarh	tikamgarh
टीकों	teekon	tikon
टु	tu	two
टेंशन	tenshon	tension
टेनिस	tenis	tennis
टेस्ट	test	test
टेस्टिंग	testing	testing
टैनिन	tanin	tainin
टैनिस	tanis	tennis
टैबू	tabu	taboo
टॉनिक	tonic	tonic
टोंगा	tonga	tonga
टोका	toka	toka
ट्यूजडे	tuws	tuesday
ट्यूनिंग	tunning	tuning
ट्यूबरक्यूलोसिस	tubrbulass	tuberculosis
ट्रक	trak	truck
ट्रांजिस्टर	trangister	trangistor
ट्रान्सफर	transper	transfer
ट्रिब्युनल	tribunnal	tribunal
ट्रिब्यूनल	tribunnel	tribunal
ट्रुथ	truth	truth
ट्रेडेड	traded	traded
ट्रेबल	trabal	trabal
ट्रैप	trap	trap
ट्रॉट	trot	trott
ठक्कर	thakkar	thakkar
ठहरने	thaharne	thaharne
ठिकाने	thikane	thikane
ठुमरी	thumari	thumri
ठेंगा	thenga	thenga
डगलस	dagalas	daglas
डभरा	dabhra	dabhara
डभोई	dabhoi	dabhoi
डम	dam	dum
डराते	darate	darate
डरावनी	daravani	dravani
डाउन	doun	down
डाक	dak	dak
डाका	daka	daka
डाबी	dabi	dabi
डाबोलिम	dabolim	dabolim
डायनासोर	diynasor	dinosaur
डायरीज	direres	diaries
डिट	dit	dit
डिप्थीरिया	dipthiriya	diphtheria
डीई	die	de
डीलरशिप	dellership	dealership
डीवीसी	dvc	dvc
डुबाना	dubana	dubana
डुबोना	dubona	dubona
डुलने	dulne	dulne
डूंगरपुर	dungarpur	dungarpur
डूबना	dubna	dubana
डेंजरस	denjars	dangerous
डेजी	dagy	daisy
डेप्युटी	depuuty	deputy
डेविडसन	devidson	devidson
डेवी	devi	davey
डेस्टिनेशन	destination	destination
डैटसन	datston	datsun
डैडी	dady	daddy
डॉर्क	dork	dark
डोज	doj	dose
डोमेनिक	domenic	domenic
डोरंडा	doranda	doranda
डोलने	dolne	dolne
ड्युअल	duall	dual
ड्यूक	dukk	duke
ड्रामे	drame	drame
ड्रेजर	drager	drager
ढकाल	dhakal	dhakaal
ढले	dhale	dhale
ढूंढ	dhundh	dhoondh
ढूंढता	dhundhata	dhoondhata
ढूंढी	dhundhi	dhundhi
तंजावुर	tanjavur	tanjavur
तंत्र	tantra	tantra
तंत्रिकाओं	tantrikaon	tantrikaon
तंत्रों	tantron	tantron
तगड़े	tagade	tagade
तड़ीपार	tadipar	tadipaar
तनी	tani	tani
तपन	tapan	tapan
तरफा	tarfa	tarfa
तरबगंज	tarbaganj	tarabganj
तरस	taras	taras
तराश	tarash	taraash
तराशे	tarashe	tarashe
तरीको	tariko	tariko
तर्क	tark	tark
तर्कवाद	tarkavad	tarkvaad
तर्कों	tarkon	tarkon
तलबगार	talabgar	talabgaar
तलवे	talwe	talve
तलवों	talvon	talvon
तहखाना	tahkhana	tahkhana
तांता	tanta	tanta
तांबे	tanbe	tambe
ताजा	taja	taaza
तानसेन	tansen	tansen
तापमानों	taammanon	tapmanon
ताप्ती	tapti	tapti
ताराबाई	tarabai	tarabai
तासीर	tasir	tasir
ताहि	tahi	tahi
तिकोने	tikone	tikone
तिरूपति	tirupati	tirupati
तिवारी	tivari	tiwari
ती	ti	ti
तीर	teer	teer
तीरों	tiron	teeron
तीर्थाटन	tirthatan	tirthatan
तुंगनाथ	tunganath	tungnath
तुगलक	tugalak	tuglak
तुगलकाबाद	tugalkabad	tughlakabad
तुगलकी	tuglaki	tugalaki
तुफैल	tufail	tufail
तेजाजी	tejaji	tejaji
तेजी	teji	teji
तेल	tel	tel
तेलों	telon	telon
तो	to	to
तौल	taul	taul
त्यौहार	tyauhar	tyohaar
त्यौहारों	tyauharon	tyauharon
त्रिजटा	trijjita	trijata
त्रिया	triya	triya
त्रैमासिक	tramaisik	trimasik
त्से	tse	tse
थकी	thaki	thaki
थर्टी	tharty	thirty
थाणे	thane	thane
थानवी	thanvi	thanvi
थिएटरों	thiatoron	theateron
थिएटर्स	thiaters	theaters
थियेटर	thiyator	theater
थियेटरों	thiyetoron	theateron
थियेटर्स	theyetors	theaters
थिरके	thirke	thirke
थीफ	theef	thief
थेन	then	then
थेनी	theni	theni
थैली	thaili	thaili
थैले	thaile	thaile
दंग	dang	dang
दंगा	danga	danga
दंगों	dangon	dangon
दंपति	dampati	danpati
दंपतियों	dampatiyon	dampatiyon
ददरेवा	dadareva	dadreva
दमोह	damoh	damoh
दरदरा	dardara	dardara
दरमियान	darmiyan	darmiyan
दर्जनों	darjanon	darjanon
दर्प	darp	darp
दर्रा	darra	darra
दलबदल	dalabdal	dalbadal
दली	dali	dali
दस्ताना	dastana	dastana
दस्तावेज	dastavej	dastavej
दहन	dahan	dahan
दहल	dahal	dahal
दा	da	da
दाखिल	dakhil	dakhil
दाखिले	dakhile	dakhile
दाता	data	daataa
दादरी	dadari	dadari
दानशील	danshil	danshil
दाभोलकर	dabholkar	dabholkar
दामले	damle	damle
दायित्व	dayitva	dayitv
दायित्वों	dayitvon	dayitvon
दारूल	darul	darul
दाव	daav	daav
दाह	dah	daah
दिखला	dikhkala	dikhla
दिखाइये	dikhaiye	dikhaiye
दिखाई	dikhai	dikhaai
दिखाईं	dikhain	dikhaaee
दिखायी	dikhayi	dikhayi
दिखार्इ	dikharr	dikhaai
दिता	dita	ditaa
दिनांक	dinank	dinank
दिरहम	dirhaham	dirham
दिलाये	dilaye	dilaye
दिवानी	diwani	diwani
दिव्य	divya	divya
दिव्यता	divyata	divyata
दिव्या	divya	divya
दीपन	dipan	deepan
दीपसिंह	dipsingh	deepsingh
दीपिका	dipika	deepika
दीया	diya	diya
दुकानों	dukanon	dukaanon
दुक्के	dukke	dukke
दुखन	dukhan	dukhan
दुखित	dukhit	dukhit
दुखियों	dukhiyon	dukhiyon
दुखों	dukhon	dukhon
दुभाषियों	dubhashiyon	dubhashiyon
दुर्गुण	durgun	durgun
दुर्घटना	durghana	durghatna
दुर्नीति	durniti	durniti
दुर्भिक्ष	durbhiksh	durbhiksh
दुविधाएं	duvidhayen	duvidhaen
दूने	dune	dune
दूरदर्शन	durdarshan	doordarshan
दृढ़	dridh	dradh
देखोगे	dekhoge	dekhoge
देनेवाली	denewali	denevali
देवनार	devnar	deonar
देवापुर	devapur	devapur
देवी	devi	devi
देवीसिंह	devisingh	devisingh
देशकाल	deshkal	deshkaal
देशके	deshke	deshke
देसाई	desai	desai
दोगे	doge	doge
द्वादश	dwadash	dvadash
द्विवेदी	dvivedi	dwivedi
धंधे	dhandhe	dhande
धंधों	dhandhon	dhandhon
धकेलते	dhakelate	dhakelte
धटना	dhatna	dhatna
धनकुबेर	dhankuber	dhankuber
धनधान्य	dhandhanya	dhandhanya
धमकाता	dhamkata	dhamkata
धम्म	dhamm	dhamm
धम्मा	dhamma	dhamma
धर्मनाथ	dharmnath	dharmnath
धर्मराज	dharmaaj	dharmraj
धर्मेश	dharmesh	dharmesh
धस्माना	dhasmana	dhasmana
धाक	dhak	dhaak
धागा	dhaga	dhaaga
धातुएं	dhatuen	dhaatuein
धारक	dharak	dharak
धारी	dhari	dhari
धुआं	dhuan	dhuan
धुनाई	dhunai	dhunai
धुरिया	dhuriya	dhuriya
धूनी	dhuni	dhuni
धैर्यवान	dhairyavan	dhairyavaan
धोखेबाज	dhokhebaaj	dhokebaaj
धोना	dhona	dhona
धोराजी	dhoraji	dhoraji
धोरों	dhoron	dhoron
ध्येयवादी	dhyeyavadi	dhyeyavaadi
ध्रुपद	dhrupad	dhrupad
नंदनवन	nandanvan	nandanvan
नक्सल	naksal	naksal
नक्सलवाद	naksalvad	naksalavaad
नक्सलियों	naksaliyon	naksaliyon
नक्सली	naksali	naksali
नगाड़ा	nagada	nagaada
नगीने	nagine	nagine
नजरंदाज	najarandaz	najarandaaj
नजराने	najarane	najraane
नजरियों	najariyon	najariyon
नजरों	najaron	najron
नजीब	najeeb	najeeb
नजीबाबाद	najibabad	najibabad
नजीम	najim	najeem
नना	nana	nana
नन्हें	nanhen	nanhe
नब्ज़	nabz	nabj
नमकीन	namkin	namkin
नरनारी	narnari	narnaari
नरभक्षी	narbhbhshi	narbhakshi
नरम	naram	naram
नरमी	narmi	narmi
नरसंहार	narsanhar	narsanhar
नरसंहारों	narsanharon	narsanharon
नवंबर	navambar	november
नवकेतन	navketan	navketan
नवजागरण	navjagaran	navjagran
नवधा	navdha	navdha
नववधू	navvdhu	navvadhu
नवा	nava	nava
नवाते	navate	navate
नवानगर	navanagar	navanagar
नव्या	navya	navya
नसीम	nasim	nasim
नाइट्रस	nitras	nitrous
नाइनटीज	ninetaes	nineteez
नाऊ	nau	nau
नाकाम	nakam	nakam
नागारिक	nagarik	naagrik
नागिन	nagin	nagin
नाडेप	nadep	nadep
नानक	nanak	nanak
नानावती	nanawati	nanavati
नापने	napne	napane
नापा	napa	napa
नाम	nam	naam
नामधारी	namdhari	naamdhari
नामांकनों	namankanon	namankanon
नामावलियों	namaalliyon	namavaliyon
नामो	namo	naamo
नायक	nayak	nayak
नाराजी	naraji	naraji
नारायणगढ़	narayangarh	naraingarh
नासर	nasar	naasar
नाहरगढ	nahargah	nahargarh
निकलेगी	nikalegi	nikalegi
निकालनी	nikaalni	nikaalani
निकी	niki	niki
निकेतन	niketan	niketan
निखर	nikhar	nikhar
निखरी	nikhari	nikhari
निगर	nigar	nigar
निचला	nichala	nichala
नितियों	nitiyon	nitiyon
नित्या	nitya	nitya
निधान	nidhan	nidhaan
निपटारा	niptara	niptaara
नियंता	niyanta	niyanta
निया	niya	niyaa
निर्देशिका	nirdeshika	nirdeshika
निर्धारित	nirdharit	nirdharit
निर्बाध	nirbadh	nirbadh
निवेशकर्ता	niveshkarta	niveshakartaa
निश्चल	nishchal	nishchal
निष्णात	nishnat	nishnaat
निष्पाप	nishpap	nishpaap
निहलानी	nihhelani	nihalaani
निहालचंद	nihalchand	nihalchand
नीचाई	nichai	nichaai
नीट	net	neat
नीतियों	nitiyon	nitiyon
नीलगाय	nilgaay	nilgai
नीलाभ	nilabh	neelaabh
नुस्खे	nuskhe	nuskhe
नून	nun	noon
नूबिया	nubiya	nubiya
नृत्यशैली	nrityashali	nrityashaili
नृत्यों	nriryon	nrityon
नेको	neko	neko
नेक्टर	nector	nectar
नेग	nag	neg
नेटवर्किग	networkigg	networking
नेटो	neto	neto
नेता	neta	neta
नेमो	nemo	nemo
नेल्सन	nelson	nelson
नेशंस	nathins	nations
नेहरा	nehra	nehra
नैनो	naino	nano
नैवेद्य	naivedya	naivedh
नॉमिनेट	nominat	nominate
नोकरी	nokari	nokari
नोट्स	notss	notes
नोरा	nora	nora
नोरी	nori	nori
नौनेर	naunner	nauner
नौवहन	nauvahan	nauvahan
नौशाद	naushad	naushad
पंचांग	panchang	panchang
पंजाब	panjab	punjab
पंजाबियों	panjabiyon	punjabiyon
पंटर	pantar	pantar
पकाएं	pakaen	pakaayein
पकौड़े	pakaude	pakaude
पक्षपात	pakshpat	pakshapat
पगबाधा	pagbadha	pagbadha
पगला	pagla	pagla
पचाता	pachata	pachaataa
पटककर	patakkar	patakkar
पटकथाएं	patkathaen	patkathaayein
पटकी	pataki	patki
पटरानी	patrani	patrani
पटवारी	patwari	patwari
पटाक्षेप	patakshep	pataakshep
पटिया	patiya	patiya
पडरौना	padaraana	padrauna
पड़ेगा	padega	padegaa
पढ़ा	padha	padha
पढ़ाता	padhaata	padhaataa
पतीली	patili	patili
पदमावती	padmavati	padamawati
पदाधिकारी	padadhikari	padadhikari
पनपना	panpana	panpana
पनामा	panama	panama
पनीर	panir	paneer
पम्मी	pammi	pammi
परदेसियों	pardesiyon	pardesiyon
परदेसी	pardesi	pardesi
परवा	parwa	parva
पराधीन	paradhin	paraadheen
परिकल्पित	parikalpit	parikalpit
परिमल	parimal	parimal
परिषद	parishad	parishad
परिषदीय	parishdiya	parishadiya
परिषदों	parishadon	parishadon
परीक्षाएं	parikshayen	parikhaen
परोसने	parosane	parosne
पर्दा	parda	parda
पर्पल	parpal	purple
पलटने	palatne	paltane
पलारी	palari	palari
पले	pale	pale
पल्मोनरी	palmonriy	palmonari
पल्स	pals	pulse
पश्तून	pashtun	pashtun
पहन	pahan	pahan
पहनता	pahanta	pahantaa
पहनते	pahnate	pahanate
पहनाकर	pahnakar	pahnaakar
पहनाती	pahnaati	pahnaati
पहनी	pahni	pahani
पहनो	pahno	pahno
पहला	pahle	pahla
पहेलियां	paheliyan	paheliyan
पहेलियों	paheliyon	paheliyon
पाइड	pide	pied
पाइथागोरस	pithhagors	pythagoras
पाखंडी	pakhandi	pakhandi
पाठशालाएं	pathashalaen	paathshaalaayein
पाठ्यक्रम	pathyarkam	paathyakram
पाठ्यक्रमों	pathyaramamon	paathyakramon
पापुलेशन	papulation	population
पायलट	piyalt	pilot
पायलटों	payalaton	piloton
पारंपरिकता	paramparikata	paarampariktaa
पार्नेल	parnel	parnel
पार्लरों	parlaron	parleron
पार्षद	parshad	parshad
पार्षदों	parshadon	paarshadon
पालिसी	palisi	policy
पिंटा	pinta	pinta
पिएगा	piyge	piega
पिक	pik	pick
पिकी	piki	piki
पिक्चर	pictur	picture
पिगमेंटेशन	pigmamentation	pigmentation
पिग्स	pigs	pigs
पिछड़े	picchhade	pichhade
पिज्जा	pijja	pizza
पितामह	pitamah	pitamah
पिपरा	pipra	pipra
पिपली	piplai	pipli
पियरसन	piyarsan	pearson
पियरी	piyari	peary
पिसाई	pisai	pisaai
पिहानी	pihahi	pihani
पीआईबी	pib	pib
पीआर	pr	pr
पीएमएल	pml	pml
पीएमओ	pm	pmo
पीएमसीएच	pmcc	pmch
पीएसवी	ps	psv
पीकिंग	pikking	picking
पीटने	pitne	pitne
पीडिया	pidia	pedia
पीलेपन	pilepan	pilepan
पीवी	pvvi	pv
पीसा	pisa	pisa
पुतला	putla	putla
पुतलियां	putliyan	putliyan
पुतलियों	putliyon	putliyon
पुतली	putli	putli
पुतले	putle	putle
पुतिन	putin	putin
पुतुल	putul	putul
पुनर्गठन	punargahan	punargathan
पुना	puna	puna
पुराने	purane	purane
पुरू	puru	puru
पुर्जों	purjon	purjon
पुलम	pulam	pulam
पुश्किन	pushkin	pushkin
पुष्करणा	pushkarana	pushkarana
पुष्प	pushpa	pushp
पुष्पा	pushpa	pushpa
पुष्पित	pushpit	pushpit
पुष्पों	pushpon	pushpon
पूंजीकरण	puonjikaran	punjikaran
पूजापाठ	pujapath	pujapath
पूरनपुर	purarpur	puranpur
पूर्वाभास	purvabhas	purvabhas
पेंडुलम	pendulam	pendulum
पेग	pagg	peg
पेजेज	pajjeg	pages
पेस	pass	pace
पेस्ट्री	pestroy	pastry
पैंगोलिन	pangolin	pangolin
पैकर्ड	paikard	packard
पैकेज	packege	package
पैकेजों	packegon	packageon
पैम	pam	pam
पैराट्रूपर	parrtroper	paratrooper
पैरानॉर्मल	paranormal	paranormal
पैराफिन	parapin	paraffin
पैराबोला	pairabola	parabola
पॉलिमर	polimar	polymer
पॉलिशिंग	palishing	polishing
पोकर	pokar	poker
पोलिश	polish	polish
पोषित	poshit	poshit
पोस्ता	posta	posta
पौ	pau	pau
प्यादे	pyade	pyade
प्रक्रिया	prakriya	prakriya
प्रक्षेपक	prakshepak	prakshepak
प्रतिज्ञा	pratigya	pratigya
प्रतिभूतियां	pratibhutiyan	pratibhutiyan
प्रतियों	pratiyon	pratiyon
प्रतिवाद	prativad	prativad
प्रतिवादी	prativadi	prativadi
प्रतिशत	pratishat	pratishat
प्रनीत	pranit	pranit
प्रपात	prapat	prapat
प्रपातों	prapaton	prapaton
प्रबोधिनी	prabodhini	prabodhini
प्रयासरत	prayasarat	prayasarat
प्रर्दशन	prardashan	pradarshan
प्रवत्ति	pravatti	pravatti
प्रशासनिक	prashasanik	prashasnik
प्रशासनों	prashasanon	prashaasanon
प्रशिक्षु	prashikshu	prashikshu
प्रस्तावों	prastavon	prastaavon
प्रहलाद	prahlhad	prahlad
प्रहसन	prahshan	prahasan
प्रहारक	praharak	praharak
प्रह्लाद	prahlad	prahlad
प्राइवेसी	privews	privacy
प्राक्कथन	prakkhaah	prakkathan
प्राण	pran	pran
प्राणों	pranon	pranon
प्राथमिक	prathmik	prathmik
प्राथमिकता	prathmikata	prathmikta
प्राथमिकी	prathmiki	prathmiki
प्राध्यापकों	pradhyapakon	pradhyapakon
प्राप्त	prapt	prapt
प्राप्ती	prapti	prapti
प्रारूप	prarup	prarup
प्रियामणि	priyaamani	priyamani
प्रूफ	pruff	proof
प्रेक्षकों	prekshakon	prekshakon
प्रेम	pram	prem
प्रेमलता	premamata	premlata
प्रेमा	prema	prema
प्रेमी	pramy	premi
प्रॉफिट	proffit	profit
प्रॉसेसिंग	prosssssing	processing
प्रोग्रामर्स	programers	programers
प्रोटो	proto	proto
प्रोपेलेंट	propalent	propellant
प्रौढ	praudh	praudh
प्लेन	plan	plane
फंड	fund	fund
फंडा	phanda	funda
फंडिंग	funding	funding
फंदों	fandon	fandon
फगुआ	phagua	fagua
फटने	fatne	fatane
फड़फड़ाता	fadfadaata	fadfadata
फतेहगढ़	fatehgarh	fatehgarh
फब्ती	fabti	fabti
फरसे	farse	pharse
फरहीन	farhane	farheen
फर्थ	farth	farth
फर्मिऑन	fermin	farmion
फर्रुखाबाद	farrukhabad	farookhabad
फर्रूखनगर	farrukhanagar	farookhnagar
फलता	falata	falta
फलने	phalne	falne
फलितार्थ	falitarth	falitarth
फलीभूत	falibhut	falibhoot
फव्वारा	favvara	favvara
फव्वारे	favware	favvare
फव्वारों	favvaron	favvaron
फ़ैसला	faisla	faisla
फ़ॉलो	pholo	follow
फांसी	fanci	fansi
फातमा	fatma	fatma
फाफ	phaf	faaf
फारसी	farsi	farsi
फार्म	farm	farm
फार्मिक	farmik	formic
फार्मूले	farmule	formulae
फार्मेसी	farmesy	pharmacy
फार्मों	farmon	pharmon
फार्म्स	farms	farms
फिंगर	phinger	finger
फिक्र	ficra	fikra
फिजिशियन	phisishain	physician
फिरती	firati	firti
फिसला	phisla	fisla
फीडर	feder	feeder
फुलाए	phulaye	fulaaye
फूर्ति	furti	furti
फूस	phoos	phus
फेका	feka	feka
फेफड़ा	fefada	fefada
फेशियल	faisial	facial
फैक्ट	fact	fact
फैडरल	faddel	federal
फैलकर	failkar	failkar
फैलाइए	failaaye	failaaiye
फैलेगी	fallgi	failegi
फॉन्ट	poot	font
फोगाट	phogat	phogat
फोड़	phod	fod
फोड़ा	phada	foda
फोड़े	phode	fode
फोड़ों	phodon	fodon
फोर्टिस	fortis	fortis
फ्यूजन	fuusn	fusion
फ्यूजी	fug	fuji
फ्रांसिस्का	franciska	franciska
फ्रांसिस्को	francisco	francisco
फ्रिंज	fring	fringe
फ्रेंडशिप	frendship	friendship
फ्रॉस्ट	frost	frost
फ्लिन	flin	flin
फ्लेश	flesh	flesh
बंग	bang	bung
बंगबंधु	bangbandhu	bangbandhu
बंगभंग	bangbhang	bangbhang
बंगश	bangash	bangash
बंटने	bantane	bantne
बंधती	bandhati	bandhati
बंधान	bandhan	bandhan
बंधुओं	bandhuon	bandhuon
बंबा	bamba	bamba
बकायों	bakayon	bakayon
बकौल	bakaul	bakaul
बक्सा	baksa	baksa
बक्सी	baxy	baksi
बक्से	bakse	bakse
बख्शने	bakhshen	bakhshane
बगड़	bagad	bagad
बगीची	bagichi	bagichi
बचत	bachat	bachat
बचती	bachati	bachti
बजना	bajna	bajana
बजरंगी	bajarangi	bajrangi
बजाज	bajaj	bajaj
बटालवी	batalvi	batalvi
बढ़ाचढ़ाकर	badhachadar	badhachadhakar
बढ़ाता	badhata	badhata
बढ़ाती	badhaati	badhati
बढ़ायी	badhayi	badhayi
बढ़ाव	badhav	badhav
बढ़ोतरी	badhotari	badhotari
बतलाए	batlaye	batlaae
बतलाकर	batlakar	batlakar
बदलापुर	badlapur	badlapur
बदली	badli	badali
बदाम	badam	badam
बनवा	banva	banva
बनाम	banam	banaam
बनिया	baniya	baniya
बनू	banu	banu
बरपाया	barpaya	barpaya
बरसा	barsa	barsa
बरसाता	barsata	barsata
बरहद	barhad	barhad
बरात	barat	baraat
बरामद	baramad	baraamad
बरामदे	baramde	baramade
बरे	bare	bare
बर्थ	barth	birth
बलजीत	baljat	baljeet
बल्लभ	ballabh	ballabh
बल्ला	balla	balla
बल्ली	balli	balli
बसावा	basava	basava
बस्तियों	bastiyon	bastiyon
बहरूपिया	bahrupiya	bahrupiya
बहामास	bahamas	bahamas
बहाव	bahav	bahaav
बहावलपुर	bahawalpur	bahavalpur
बहुचरा	bahuchara	bahuchara
बांठिया	banthiya	banthiya
बांधते	bandhate	bandhate
बांबी	bambi	banbi
बाउंसरों	bounssaron	bounceron
बाउलिंग	boulling	bowling
बाकू	baku	baku
बाग	bag	baag
बागबानी	bagbani	bagbani
बागली	bagali	bagli
बागियों	bagiyon	bagiyon
बागो	bago	bago
बाज़ी	bazi	bazi
बाजारू	bajaru	bajaru
बाजुओं	bajuon	bajuon
बाध	badh	badh
बाधा	badha	badha
बाधाओं	badhaon	badhaon
बाधित	badhit	badhit
बानी	bani	bani
बापा	bapa	bapa
बाबत	babat	baabat
बायर्न	biren	bayern
बारह	barhah	barah
बारहमासी	barhahasi	barahmasi
बारहसिंगा	barhasinga	barahsinga
बाला	bala	bala
बाल्टी	balti	baalti
बाल्डविन	baldwin	baldvin
बावजी	bawaji	bavji
बावरा	bavara	baawaraa
बाहुल्य	bahulya	baahulya
बाॅक्स	bock	box
बिखेरती	bikherati	bikherati
बिगेस्ट	bigest	biggest
बिछुआ	bichhuaa	bichhuaa
बिजी	biji	biji
बिपिन	bipin	bipin
बिलाई	bilai	bilai
बिल्ला	billa	billa
बिल्हौर	bilhaur	bilhaur
बिस्वा	biswa	biswa
बीएजी	bb	bag
बीकानेर	bikaner	bikaner
बीकानेरी	bikaneri	bikaneri
बीके	bike	bk
बीजक	bijak	bijak
बीफ	beef	beef
बीम	bim	bim
बीमों	bimon	bimon
बीरगंज	birganj	birganj
बीसवां	biswan	beesavaan
बीस्ट	bist	beast
बुडविग	budvig	budwig
बुल	bul	bull
बुलाओ	bulao	bulao
बुले	bule	bule
बुलेटिन	buletin	bulletin
बृजेश	brijesh	brijesh
बेंवर	benwar	benwar
बेऔलाद	beallad	beaulad
बेकाबू	bekabu	bekabu
बेचकर	bechaar	bechakar
बेचते	bechte	bechate
बेड़ियां	bediyan	bediyan
बेथनल	bethall	bethnal
बेनिस	benis	benis
बेलचा	belcha	belacha
बेलिंडा	belinda	belinda
बेवकूफाना	bevkufana	bevkufana
बेसहारा	beshara	besahara
बेसिन	besin	basin
बेसिल	becil	basil
बैंडेज	bandage	bandage
बैठते	baithate	baithate
बैतूल	baitul	baitool
बैनी	banny	baini
बैरकपुर	bairkpur	barrackpore
बैला	baila	baila
बैलिस्टिक	ballstic	ballistic
बैल्स	balls	bells
बॉस्टन	boston	bostan
बोकारो	bokaro	bokaro
बोदरा	bodra	bodra
बोना	bona	bona
बोरकर	borkar	borkar
बोरीवली	boriwali	borivali
बोर्न	born	born
बोलने	bolne	bolane
बोलिए	boliye	boliae
बोसान	bosan	bosan
बौनी	bauni	bauni
ब्यावर	byawar	byavar
ब्रजेश	brajesh	brijesh
ब्रह्मलीन	brahmalin	brahmalin
ब्रावो	bravo	bravo
ब्रिगटन	brigggan	brigatn
ब्रिगेडियर	brigediar	brigadier
ब्रिटेन	britan	britain
ब्रीद	breed	breed
ब्रोक	brock	broke
ब्रोकन	brocan	broken
ब्लॉसम	blossm	blossom
भगाने	bhagane	bhagane
भड़काया	bhadkaya	bhadkaya
भभूत	bhabhut	bhabhut
भय	bhay	bhay
भयो	bhayo	bhayo
भरतनाट्यम्	bharatnaayam	bharatanatyam
भरते	bharte	bharte
भरनी	bharni	bharani
भरने	bharne	bharane
भरा	bhara	bhara
भविष्य	bhavishya	bhavishya
भाते	bhate	bhaate
भानू	bhanu	bhanu
भाबर	bhabar	bhabar
भारीय	bhariy	bhariy
भावनाओं	bhavnaon	bhavnaon
भास्कर	bhaskar	bhaskar
भीड़	bheed	bheed
भीरा	bhira	bhira
भीष्म	bhishm	bheesham
भुगत	bhugat	bhugat
भुगता	bhugata	bhugta
भुट्टो	bhutto	bhutto
भुमि	bhumi	bhumi
भुरभुरा	bhurbhura	bhurbhura
भूख	bhukh	bhookh
भूखी	bhukhi	bhukhi
भूगोल	bhugol	bhugol
भूतल	bhutal	bhutal
भूपसिंह	bhupsingh	bhupsingh
भूमी	bhumi	bhumi
भूलता	bhulta	bhulta
भूला	bhula	bhula
भूली	bhuli	bhuli
भूलो	bhulo	bhulo
भूलों	bhulon	bhulon
भूसी	bhusi	bhusi
भूस्वामी	bhuswami	bhuswami
भेंगापन	bhengapan	bhengapan
भैरवनाथ	bhairaanath	bhairavnath
भैरो	bhairo	bhairo
भोगते	bhogate	bhogte
भोला	bhola	bhola
भोली	bholi	bholi
भोलू	bholu	bholu
भौंहों	bhaunhon	bhaunho
भ्रांत	bhrant	bhraant
भ्रांति	bhranti	bhraanti
भ्रांतियां	bhrantiyan	bhrantiyan
भ्रांतियों	bhrantiyon	bhrantiyon
मंगेश	mangesh	mangesh
मंच	manch	manch
मंचित	manchit	manchit
मंचीय	manchiy	mancheeye
मंचों	manchon	manchon
मंजिल	manjil	manjil
मंजिला	manjila	manjila
मंजिलें	manjilen	manjilein
मंटो	manto	manto
मंत्रियों	mantriyon	mantriyon
मकरानी	makrani	makrani
मक्सद	maksad	maksad
मखदुमपुर	makhdumpur	makhdumpur
मचाए	machaye	machae
मचानों	machanon	machanon
मढ़ौरा	madhara	madaura
मणिपाल	manipal	manipal
मतपत्रों	matpatron	matpatron
मत्थे	matthe	matthe
मत्स्यावतार	matsyavaar	matsyavatar
मत्स्येंद्रनाथ	matsyendranath	matsyendranath
मधुपुर	madhupur	madhupur
मनमर्जी	manmarji	manmarji
मनाए	manaye	manae
मम	mam	mum
मयोर्का	mayorka	maryokar
मरदानी	mardani	mardani
मरमर	marmar	marmar
मराठा	maratha	maratha
मराठी	marathi	marathi
मर्जी	marji	marji
मर्दानगी	mardangi	mardangi
मर्दों	mardon	mardon
मर्यादा	maryada	maryada
मर्यादाओं	maryadaon	maryadaon
मलागा	malaga	malaga
मलार	malar	malar
मशरक	mashrak	mashrak
मसालेदार	masaledar	masaledar
मसूर	masur	masoor
मस्से	masse	masse
महकने	mahake	mahakane
महलों	mahalon	mahalon
महाग्रंथ	mahagranth	mahagranth
महाजन	mahajan	mahajan
महाथिर	mahathir	mahathir
महानतम	mahanamam	mahanatam
महानिदेशक	mahanideshak	mahanideshak
महापौरों	mahaparon	mahapauron
महाप्राण	mahapran	mahapran
महामंत्र	mahamantra	mahamantr
महाराजा	maharaja	maharaja
महाविज्ञान	mahavigyan	mahavigyan
महाविद्या	mahavidya	mahavidya
महाविष्णु	mahavishna	mahavishnu
महासिंह	mahasingh	mahasingh
महिपाल	mahipal	mahipal
महीन	mahin	mahin
महीनों	mahinon	mahinon
मांग	mang	mang
मांगनी	mangani	mangni
मांगा	manga	manga
मांगी	mangi	mangi
मांगे	mange	mange
मांगो	mango	mango
माओरी	maori	maori
माजिन	majin	majin
माथे	mathe	mathe
माप	map	maap
मामूली	mamuli	mamuli
मामे	mame	mame
मारवाड़	marwad	maarvaad
मारिया	mariya	mariya
मारियो	mariyo	mariyo
मार्था	martha	martha
मालिश	malish	malish
मावे	mawe	mave
मास	mas	maas
मासों	mason	mason
मिटाओ	mitao	mitao
मिठाई	mithai	mithaai
मिडिया	midiya	media
मिथिला	mithila	mithila
मिथिलांचल	mithilanchal	mithilanchal
मिथ्या	mithya	mithya
मिमिक्री	mimikri	mimicry
मिल्कियत	milkiyat	milkiyat
मिशा	misha	misha
मुंगेरी	mungeri	mungeri
मुंडवा	mundwa	mundwa
मुंशीगंज	munshiganj	munshiganj
मुकरते	mukarte	mukarte
मुखोपाध्याय	mukhopadhyay	mukhopadhyaya
मुख्यमंत्री	mukhyamantri	mukhyamantri
मुनाफ	munaf	munaf
मुनाफा	munafa	munafa
मुन्नू	munnu	munnu
मुफलिसी	mufffisi	muflisi
मुबारकपुर	mubarapur	mubarakpur
मुर्झा	murja	murjha
मुल्ताई	multai	multai
मुशाहिद	mushahid	mushahid
मुहावरे	muhavare	muhavare
मूठ	muth	mooth
मूड	mood	mood
मूडी	mudi	moody
मूल	mull	mool
मूलचंद	mulchand	moolchand
मूलर	muller	moolar
मूलों	mulon	mulon
मेक्सिको	mexico	mexico
मेगा	mega	mega
मेगापिक्सल	megapixis	megapixel
मेजबान	mejan	mejbaan
मेजबानी	mejbani	mejabani
मेज़बान	mejan	mejbaan
मेज़बानी	mejbani	mejbaani
मेट	mate	mate
मेट्स	mats	mates
मेडीकल	medical	medical
मेथेनॉल	methenol	methanol
मेनू	menu	menu
मेम	mam	mem
मेलघाट	melghat	melghat
मेलानिन	melanin	melanin
मेलानी	melani	melani
मेहमान	mehman	mehmaan
मेहराम	mehram	mehram
मैकबुक	macbuk	macbook
मैट्रिक्स	mattix	matrix
मैड	mad	made
मैडी	mady	maidi
मैन	man	man
मैनन	mannn	menon
मैनर	manner	manner
मैना	maina	maina
मैने	mann	maine
मैरेज	marrege	marrej
मैसाचुसेट्स	masschuuset	massachusetts
मैसोर	massor	maisor
मॉड	mod	mod
मॉडर्न	modern	modern
मॉड्यूल	modul	module
मॉड्यूल्स	modulls	modules
मॉरिशस	morritsi	mauritius
मोगली	mogali	mowgli
मोटिव	motiv	motive
मोल	mol	mol
मोल्ड	mold	mold
मोशे	moshe	moshe
मोसाद	mosad	mosad
मोहाना	mohana	mohana
मोहानी	mohani	mohani
मोहिनी	mohini	mohini
मोहिम	mohim	mohim
मौकों	maukon	maukon
मौमा	mauma	mauma
मौर्या	maurya	maurya
मौर्यों	mauryon	maurya
मौलवियों	maullviyon	maulaviyon
मौले	maule	maule
मौसा	mausa	mausa
यत्न	yatn	yatn
यदा	yada	yada
यदुवंश	yaduvansh	yaduvansh
यरूशलेम	yurushalem	jerusalem
यशपाल	yashpal	yashpal
यातना	yatna	yatna
यातनाओं	yatnaon	yatnaon
यात्राएं	yatrayen	yarayan
यारियां	yariyan	yaariyan
यारी	yari	yaari
युग्म	yugm	yugam
युद्धरत	yuddharat	yudhrat
यूक्रेनियन	ucranian	ukrainian
येरुशलम	yarushamm	jerusalem
यॉर्कर	yrucer	yorker
योजनाएं	yojnaeen	yojanaein
रंगते	rangate	rangate
रंजकता	ranjakta	rangkata
रईस	reis	raees
रक्ताभ	raktabh	raktabh
रखना	rakhna	rakhna
रघुपति	raghupati	raghupati
रघुराम	raghuram	raghuram
रजिस्टर्ड	registord	registered
रतनपुर	ratanpur	ratanpur
रनर्स	roners	runners
रयान	rayan	ryan
रल्हन	ralhan	ralhan
रविश	ravish	ravish
रवैल	ravail	ravel
रसद	rasad	rasad
रसायनिक	rasayanik	rasaayanik
रसायनों	rasayanon	rasaayanon
रहमत	rahmat	rahamat
रहेंगे	rahenge	rahenge
रहेगी	rahegi	rahegi
राउंडर	rounder	rounder
राक	rak	rak
राखे	rakhe	rakhe
रागों	ragon	raagon
राघवन	raghvan	raghavan
राज	raj	raj
राजकोट	rajkot	rajkot
राजतंत्र	rajtantra	rajtantra
राजनीतीकरण	rajnitikaran	raajneetikaran
राजमां	rajman	rajma
राजस्व	rajasv	rajasva
राजी	raji	raji
राजीनामा	rajinama	rajinama
राजों	rajon	rajon
राणा	rana	rana
रात्रिचर	ratrichar	ratrichar
राधे	radhe	radhe
रानापुर	ranapur	ranapur
राबिन	rabin	rabin
राभा	rabha	rabha
रामकोट	ramkot	ramkot
रामटेक	ramtek	ramtek
रामपुर	rampur	rampur
रामभरोसे	rambharose	rambharose
रामराज	ramraj	ramraj
रालोद	ralod	raalod
रावले	rawele	ravle
रासायनिक	rasayanik	rasayanik
रिक्रिएशन	recriation	recreation
रिग	rig	rig
रिग्स	rigs	rigs
रिचुअल	richual	ritual
रिडक्शन	redcctoon	reduction
रिपन	ripan	ripan
रिया	riya	riya
रिश्ते	rishte	rishte
रिसने	risne	risane
रिहाना	rihana	rihana
रीगल	regal	regal
रीजनल	rejnal	regional
रीट्वीट	retwet	retweet
रीता	reeta	reeta
रुकते	rukate	rukte
रुग्ण	rugn	rugna
रुग्णता	rugnata	rugnata
रुजवेल्ट	rujwalt	rojvelt
रुडोल्फ	rudolf	rudolf
रुपेश	rupesh	rupesh
रुबी	rubi	ruby
रुमानी	rumani	rumani
रूकावटों	rukavaton	rukavaton
रूट	rut	root
रूटिंग	rutiing	rooting
रूट्स	ruts	roots
रूपक	rupak	roopak
रूपी	rupi	rupi
रेंटल	rantel	rental
रेगिस्तान	registan	registan
रेगिस्तानी	registani	registani
रेजा	reja	reja
रेट	rat	rate
रेत	ret	ret
रेफेली	refely	refaeli
रेशे	reshe	reshe
रेस	rase	race
रेसर	rassor	racer
रेसिंग	ressing	racing
रेसों	reson	reson
रेहाना	rehana	rehana
रैकेटियर	racktirar	racketeer
रैडिकल	radical	radical
रैथ	rath	raith
रैपिंग	rapping	rapping
रॉबर्टसन	robertsan	robertson
रॉबिंसन	robinsen	robinson
रॉयल्स	roills	royals
रोजलिन	rojlin	rojlin
रोटेशन	rotation	rotation
रोड्रिगो	rodrigo	rodrigo
रोनाल्डो	ronaldo	ronaldo
रोनित	ronit	ronit
रोनी	roni	roni
रोपने	ropne	ropane
रोबिन	robin	robin
रोया	roya	roya
रोलर्स	rolers	rollers
रोवन	rovan	rowan
रोसारियो	rosariyo	rosariyo
रौबदार	raubbbar	raubdar
लंगड़ा	langada	langada
लंगर	langar	langar
लंगरों	langaron	langaron
लंबी	lambi	lambi
लकीर	lakir	lakir
लकीरों	lakiron	lakiron
लक्मे	lakme	lakme
लक्ष्मीधर	lakshididhar	lakshmidhar
लक्ष्य	lakshya	lakshy
लक्ष्यों	lakshyon	lakshyon
लक्स	laxk	lux
लक्सर	lakser	laksar
लख्खी	lakhkhi	lakhkhi
लगना	lagna	lagna
लगनेवाले	lagnewale	laganewale
लगेगा	lagega	lagega
लज्जालु	lajjalu	lajjalu
लटकाते	latkate	latkate
लड़की	ladki	ladki
लड़ते	ladte	ladte
लड़ाई	ladai	ladai
लड़ाईयों	ladaiyon	ladaiyon
लपेटने	lapetane	lapetane
लबादा	labada	labada
लब्ध	labdh	labdh
ललक	lalak	lalak
ललकारता	lalkarata	lalkarta
लल्ला	lalla	lalla
लवासा	lavasa	lavasa
लस्सी	lassi	lassi
लहना	lahna	lahanaa
लहराई	lahrai	lahrai
लहलहाती	lahalhati	lahlahati
लहसुन	lahsun	lahsun
लांचर	lanchar	launcher
लाइकोपिन	licconi	lycopene
लाइम	lime	lime
लाइव्स	liges	lives
लाईव	lige	live
लाएगी	layge	laegi
लागातार	lagatar	lagatar
लाता	lata	laata
लाती	lati	laati
लायेगा	layega	layega
लालपुर	lalpur	lalpur
लास्ट	last	last
लिंगभेद	lingbhed	lingbhed
लिंडन	linden	lindan
लिखकर	likhkar	likhakar
लिगर	ligar	ligar
लिबरेशन	liberation	liberation
लिब्रेशन	lebration	liberation
लीडरों	lederon	leaderon
लुईस	luice	luis
लुढ़कते	ludhate	ludhakate
लुत्फ	lutfa	lutf
लुमडिंग	lumding	lumding
लूटमार	lutmar	lootmaar
लेंडल	lendal	lendal
लेगा	lega	lega
लेटकर	latkar	letkar
लेनेवाली	lenewali	lenewali
लेबल	label	label
लेबलिंग	labling	labeling
लेबलों	leblon	labelo
लेमन	leman	lemon
लैंगडन	lanngdon	laingadan
लैंगिकता	langikta	laingikta
लैंसेट	lanset	lenset
लैरी	lary	lairi
लैस	las	less
लॉकेट	locket	locket
लॉन्ड्री	londryy	laundry
लोंगोवाल	longowal	longewal
लोग	log	log
लोगे	loge	loge
लोचदार	lochdar	lochdar
लोदी	lodi	lodi
लौरेंस	lourance	laurence
वंडर	wonder	wonder
वंश	vansh	vansh
वंशधर	vanshdar	vanshdhar
वंशवाद	vanshwad	vanshvad
वजूद	vajud	vajud
वडाली	vadali	wadali
वनिता	vanita	vanita
वरेण्य	varenya	varenya
वर्ण	varn	varn
वर्णित	varnit	varnit
वर्तमान	vartman	vartaman
वर्द्धमान	varddhman	varddhaman
वर्बल	varbal	verbal
वर्शन	vartin	version
वर्साचे	varsache	varsaache
वल्कन	valkan	valkan
वश	vash	vash
वशीकरण	vashikaran	vashikaran
वांगचुक	vangachuk	vaangchuk
वांट	want	want
वाइज	wije	vije
वाटर	water	water
वाटसन	vatsan	watson
वाण	van	vaan
वाणों	vanon	vaanon
वातानुकूलन	vatanukulan	vatanukulan
वादक	vadak	vadak
वादियों	vadiyon	vaadiyon
वायना	vayana	vayana
वायरलेस	wirerass	wireless
वारियर्स	wariers	warriors
वाल्व	walv	valve
वास्तविक	vastavik	vastvik
वाहिकाएं	vahikaeen	vahikayen
विंटर	winter	winter
विंसेंट	winsent	vincent
विकल्पों	vikalpon	vikalpon
विकेट	wicket	wicket
विक्रमजीत	vikramjeet	vikramjeet
विचारकों	vicharakon	vicharakon
विज्ञान	vigyan	vigyan
विज्ञानी	vigyani	vigyani
विज्ञानों	vigyanon	vigyanon
विट्ठल	vitthal	vitthal
विठ्ठल	vithtal	viththal
वितर्क	vitark	vitark
विद्याएं	vidyayen	vidhaaein
विद्याओं	vidyaon	vidhaaon
विधानसभाएं	vidhansabheen	vidhansabhaen
विधिवत	vidhivat	vidhivat
विधुत	vidhut	vidhut
विनष्ट	vinsht	vinasht
विनीत	vinit	vineet
विपरीतता	viparitta	vipritata
विप्रा	vipra	vipra
विप्रो	vipro	wipro
विभा	vibha	vibha
विभाजक	vibhajak	vibhajak
विभ्रम	vibhram	vibhram
विमर्श	vimarsh	vimarsh
विमर्शों	vimarshon	vimarshon
विराजती	virajati	virajati
विरेचन	virechan	virechan
विरोध	virodh	virodh
विरोधाभासी	virodhabhasi	virodhabhasi
विरोधाभासों	virodhabhason	virodhabhason
विविध	vividh	vividh
विवेकहीन	vivekahin	vivekheen
विशेषण	visheshan	visheshan
विशेषणों	visheshanon	visheshanon
विशेषाधिकार	visheshadhikar	visheshadhikar
विश्वसनीय	vishwasanniy	vishwasaniy
विश्वसनीयता	vishwasnayata	vishwasaniyata
विषहीन	vishanien	vishhin
विष्णु	vishnu	vishnu
वीएलसी	vlc	vlc
वीक्स	wixe	weeks
वीरचंद	virchand	veerchand
वीरेश	viresh	viresh
वृत्तों	vrirton	vritton
वेंकटरमन	venkktamaman	venkatraman
वेड	wad	ved
वेडिंग	wedding	wedding
वेदियों	vediyon	vediyon
वेदों	vedon	vedon
वेनेजुएला	venejuala	venezuela
वेरोनिका	veronica	veronica
वेलवेट	velwate	velvet
वेल्डर	walder	weldor
वेल्डिंग	welding	welding
वेल्थ	velth	wealth
वेल्लूर	vellur	vellur
वेश	vesh	vesh
वेस्टिंग	vesting	wasting
वेस्टिंगहाउस	vestinghhus	westinghouse
वेस्ले	vesle	vaisley
वैज्ञानिक	vaigyanik	vaigyanik
वैज्ञानिकता	vaigyanikata	vaigyaanikta
वैत्रवती	vaitrawati	vaitravati
वैमनस्य	vainanasy	vaimanasy
वैरी	wairy	very
वैशाख	vaishakh	vaishakh
वैशाखी	vaishakhi	vaishakhi
वैष्णोदेवी	vashnddddvi	vaishnodevi
व्यक्तिगत	vyaktigat	vyaktigat
व्यग्र	vyagra	vyagra
व्यतीत	vyatit	vyatit
व्यभिचार	vyabhichar	vyabhichar
व्यवधान	vyavdhan	vyavdhan
व्यवहारगत	vyavhargaat	vyavahargat
व्याघात	vyaghat	vyaghat
व्यापक	vyapak	vyapak
व्लाद	wlad	vlad
व्लादिमीर	vladimir	vladimir
शंघाई	shanghai	shanghai
शतपथ	shatpath	shatpath
शनिवार	shanivar	shanivar
शबाना	shabana	shabana
शब्दार्थ	shabdarth	shabdarth
शमादान	shamadan	shmadan
शमिताभ	shamitabh	shamitabh
शमिल	shamil	shamil
शराबों	sharabon	sharabon
शरारत	shararat	shararat
शर्माना	sharmana	sharmana
शहरवासियों	shahrarasiyon	shaharwasiyon
शहादरा	shahadra	shahdara
शांतिकाल	shantikal	shantikal
शाओ	shao	shao
शाकिर	shakir	shaakir
शाखाएं	shakhayen	shaakhaaen
शायक	shayak	shayak
शावकों	shavakon	shaavakon
शासक	shasak	shasak
शासकों	shaskon	shasakon
शिप्रा	shipra	shipra
शिर्के	shirke	shirke
शीर्षकों	shirshkon	sheershakon
शुजात	shujat	shujat
शुटिंग	shuting	shooting
शुड	shud	shud
शुभंकर	shubhankar	shubhankar
शुमाली	shumali	shumali
शृंगार	shringar	shringaar
शेलिंग	shelling	shelling
शैली	shaili	shaili
शैशव	shashav	shaishav
शॉन	shon	shaun
शोर्ट	short	short
श्योर	shyor	sure
श्रंखला	shrankhala	shrankhala
श्रंखलाओं	shrankhalaon	shrankhalaaon
श्रावणी	shravnni	shravani
श्रीकर	shrikar	shrikar
श्रीखंड	shrikhand	shrikhand
श्रीमति	shrimati	shrimati
श्रीराम	shriram	shriram
श्रोताओं	shrotaon	shrotaon
षट्	shatt	shat
संख्याएं	sankhyayen	sankhyaein
संघनित	sanghanit	sanghanit
संचयन	sanchayan	sanchayan
संचार	sanchar	sanchar
संचारी	sanchari	sanchari
संचालनों	sanchalanon	sanchalnon
संजय	sanjay	sanjay
संजीवन	sanjivan	sanjivan
संतति	santati	santati
संदर्भ	sandarbh	sandarbh
संदर्भों	sandarbhon	sandrbhon
संदली	sandali	sandali
संधान	sandhan	sandhan
संप्रति	samprati	samprati
संप्रभु	samprabhu	samprabhu
संप्रभुता	samprabhuta	samprabhuta
संबित	sambit	sambit
संभालने	sambhalane	sambhalne
संभ्रांत	sambhrant	sambhrant
संयुक्त	sanyukt	sanyukt
संयुक्ता	sanyukta	sanyukta
संयोगवश	sanyogavash	sanyogvash
संयोजन	sanyojan	sanyojan
संयोजनों	sanyojanon	sanyojanon
संवेदीकरण	sanvedikaran	sanvedikaran
संशयों	sanshyon	samshayon
संस्कार	sanskar	sanskar
संस्कारी	sanskari	sanskari
संस्कृत	sanskrit	sanskrit
संस्कृतियां	sanskritiyan	sanskritiyan
संस्कृतियों	sanskritiyon	sanskritiyon
संस्थित	sansthit	sansthit
संस्थिता	sansthita	sansthita
सकरा	sakara	sakra
सक्शन	saction	suction
सच्चिदानंद	sacchidandand	sacchidanand
सज्जा	sajja	sajja
सत	sat	sat
सतपाल	satpal	satpal
सतलुज	satluj	satluj
सताने	satane	satane
सते	sate	sate
सत्ती	satti	satti
सत्वत	satvat	satvat
सदानंद	sadanand	sadanand
सपने	sapne	sapane
सपरिवार	sapariwar	saparivaar
सपाट	sapat	sapat
सपाटे	sapate	sapate
सप्तक्रांति	saptakranti	saptakranti
सप्तपदी	saptpadi	saptapadi
सप्तरी	saptari	saptari
सप्रमाण	saprman	sapraman
सबमिट	submit	submit
सबमिशन	sabmishan	submission
सभाएं	sabhayen	sabhaein
सभासदों	sabhasadon	sabhasadon
सभ्यता	sabhyata	sabhyata
समझूंगा	samjhunga	samjhunga
समन	saman	saman
समन्वयक	samanvak	samanvayaka
समाधान	samadhan	samadhan
समाधियों	samadhiyon	samadhiyon
समालखा	samalkha	samalakha
समाहार	samahar	samahar
समितियां	samitiyan	samitiyan
समेटती	sametati	sametati
सरका	sarka	sarka
सरकारें	sarkaren	sarkaren
सरकारों	sarkaron	sarkaron
सरगना	sargana	sargana
सरगनाओं	sarganaon	sarganaon
सरगी	sargai	sargi
सरगुजा	sargaja	sarguja
सरसा	sarsa	sarsa
सरहिंद	sarhand	sarahind
सराहा	saraha	saraha
सराही	sarahi	sarahi
सलाहकार	salahkar	salaahkar
सलीब	salib	salib
सलेक्ट	salect	select
सल्तनत	saltanat	saltanat
सवाल	sawal	sawal
सहकलाकार	sahkalakar	sahkalakar
सहदेव	sahdev	sahdev
सहरावत	saharawat	sahrawat
सहूलियत	sahuliyat	sahuliyat
सांकेतिक	sanketik	sanketik
साइमंस	simmens	saimans
साइमा	saima	saima
सागरिका	sagarika	sagarika
सागा	saga	saga
साजन	sajan	sajan
साजसज्जा	sajsajja	saajsajja
साजा	saja	saja
साथसाथ	sathsath	saathsaath
साथिया	sathiya	sathiya
साबाह	sabah	sabah
सामंजस्य	samanjasya	samanjasya
सामोआ	samoa	samoa
सायं	sayan	saayn
सायरा	sayara	sayara
साल्वे	salve	salve
साहब	sahab	sahab
सिंगापुर	singapur	singapore
सिंगार	singar	singaar
सिंघाड़े	singhade	singhaadey
सिंघी	singhi	singhi
सिंहा	sinha	sinha
सिएरा	siyra	sierra
सिकुड़	sikud	sikud
सिगनल्स	signnes	signals
सिगरेटों	sigaraton	cigaretton
सिद्धवट	siddhavat	siddhivat
सिनाबंग	sinabang	sinabang
सिनेप्स	sineps	synapse
सिपाह	sipah	sipah
सिपाहियों	sipahiyon	sipahiyon
सिपाही	sipahi	sipahi
सिम	sim	sim
सिमट	simat	simat
सिमटता	simatta	simatataa
सिमटे	simate	simate
सिमी	simi	simi
सिम्स	sims	sims
सियासी	siyasi	siyasi
सियाह	siyah	siyah
सिरपुर	sirpur	sirpur
सिवान	sivan	siwan
सिसवा	siswa	siswa
सीआईएल	cil	cil
सीएसआई	csi	csi
सीकर	sikar	sikar
सीटें	siten	seaten
सीताराम	sitaram	sitaram
सीताहरण	sitaharan	sitaharan
सीपीएम	cpm	cpm
सीपीएस	cps	cps
सीबीएसई	cbs	cbse
सीम	sem	sim
सील्ड	sild	sealed
सीसीडी	ccd	ccd
सुगमता	sugamta	sugamata
सुजेन	sujen	sujan
सुजैन	sujain	sujain
सुझाती	sujhati	sujhati
सुतली	sutli	sutali
सुता	suta	suta
सुदीप	sudip	sudip
सुधारगृह	sudhargrah	sudhaargrah
सुनारों	sunaron	sunaron
सुनासीर	sunasir	sunaseer
सुनीति	suniti	suniti
सुनेगा	sunega	sunega
सुपरहिट	suparhit	superhit
सुपाच्य	supachya	supachy
सुभाय	subhay	subhay
सुरवीन	survin	survin
सुराणा	surana	surana
सुलखान	sulkhan	sulkhan
सुलझाई	suljhai	suljaayi
सुलताना	sultana	sultana
सुलाती	sulati	sulati
सुसंस्कृत	susanskrit	susanskrit
सुहागिन	suhagin	suhagin
सूंड़	sund	sund
सूइयां	suiyan	suiyan
सूखती	sukhti	sukhti
सूखाकर	sukhakar	sukhakar
सूचक	suchak	suchak
सूजा	suja	sooja
सूबा	suba	suba
सूबे	sube	sube
सूरज	suraj	suraj
सूरीनाम	surinam	surinaam
सूर्यदेव	suryadev	suryadev
सेंधा	sendha	sendha
सेंवई	senviy	senvai
सेंसिंग	sensing	sensing
सेक्सुअल	sexucal	sexual
सेटरडे	seterya	saturday
सेटी	sety	seti
सेटो	seto	seto
सेथ	seth	seth
सेफ्टी	sefty	safety
सेमिन	semin	semin
सेल्फ	self	self
सेल्फी	selfy	selfie
सेव	seve	save
सेवकों	sevaon	sevakon
सैम्युल्स	samulls	samuels
सैलरी	sallery	salary
सॉकर	socker	sakar
सॉन्ग्स	songs	songs
सॉलिसिटर	solicitor	solicitor
सोचने	sochne	sochane
सोनू	sonu	sonu
सोमा	soma	soma
सोमी	somi	somi
सोय	soy	soy
सोया	soya	soya
सोलिटेयर	solitare	solitaire
सोहराई	sohrai	sohrai
सोहावल	sohawal	sohawal
सौंपने	saumpane	saunpane
स्काला	skala	scala
स्की	skiy	ski
स्कूटरों	skhotoron	scootaron
स्कैंडिनेविया	scandinaa	scandinavia
स्कैनिंग	scanning	scanning
स्क्वाश	squash	squash
स्क्वैश	squais	squash
स्खलन	skhalan	skhalan
स्टैन	stan	stan
स्टॉप	stop	stop
स्टॉप्स	stops	stops
स्टोन	ston	stone
स्ट्रास	stras	straws
स्ट्रे	strey	stra
स्ट्रोक्स	strox	strokes
स्तन	stan	stan
स्तनधारी	standhari	standhari
स्तिथि	stithi	stithi
स्तुति	stuti	stuti
स्थितियां	sthitiyan	sthitiyan
स्थितियों	sthitiyon	sthitiyon
स्थूल	sthul	sthul
स्थूलता	sthulta	sthulata
स्नीकर्स	snickers	sneakers
स्पीयर	spear	spear
स्पेल	spale	spell
स्पेलर	spaller	speller
स्प्रिट	sprit	sprit
स्प्रे	spre	spray
स्फूर्ति	sfurti	sfoorti
स्लाइड	slide	slide
स्लाइडर	slyder	slider
स्लाइडों	slyden	slidon
स्लाइड्स	slyde	slides
स्लाइस	slice	slice
स्लैश	slash	slash
स्वरुपों	swarupon	swarupon
स्वा	swa	swa
स्वाचालित	swachalit	swachalit
स्वार्थपरक	swarthparak	swarthparak
स्विफ्टलेट	swiftlelet	swiftlet
स्वीकारते	swiekarate	swikarte
स्वीट	sweet	sweet
स्वीप	swep	sweep
स्वेच्छा	swechha	sweccha
स्वेता	sweta	sweta
स्वैप	swap	swap
हंडिया	hundiya	handiya
हकीकत	hakikat	hakikat
हथिया	hathiya	hathiya
हमला	hamla	hamla
हमलावर	hamlavar	hamalavar
हमाल	hamal	hamaal
हरक्यूलिस	harcullis	hercules
हरदास	hardas	hardas
हरपाल	harpal	harpal
हरवंश	harwansh	harvansh
हरावल	harawal	harawal
हरिकेन	harikan	hurricane
हरिजन	harijan	harijan
हरियाली	hariyali	hariyali
हर्षित	harshit	harshit
हल्दी	haldi	haldi
हल्ला	halla	halla
हवामहल	hawamhal	hawamahal
हवालात	hawalat	hawalat
हसीनों	hasinon	hasinon
हां	han	han
हांफते	hanfate	haanfte
हाइमन	himman	hymen
हाड़ौती	hadauti	hadauti
हानी	hani	hani
हारजीत	harjit	haarjeet
हारना	harna	harna
हालचाल	halchal	haalchaal
हाल्ट	halt	halt
हाहाकार	hahakar	hahakar
हिंगिस	hingis	hingis
हिंडन	hindan	hindan
हिजड़ा	hijaja	hijada
हिजबुल	hijbal	hijbul
हिप्पो	hippo	hippo
हिप्पोपोटेमस	hippopomems	hippopotamus
हिमाली	himali	himali
हिलने	hilne	hilne
हिशाम	hisham	hisham
हीरागंज	hiraganj	hiraganj
हीरोज	heroj	heroes
हुईं	huin	huin
हूपर	hupar	hooper
हेगडे	hegde	hegde
हेमवती	hemwati	hemwati
हेल्प	help	help
हेल्पर	helper	helper
हैतो	haito	haito
हैरम	haram	hairam
हैराल्ड	harald	herald
हैव	haiv	have
हॉन्ग	hong	hong
हॉफ	hoff	half
होऊंगा	hoonga	hounga
होल्डिंग	holding	holding
होशंगाबाद	hoshangaaad	hoshangabad
होस्टेस	hostes	hostess
