prediction	ground_truth
अंक	ank	ank
अंकित	ankit	ankit
अंकों	ankon	ankon
अंकोर	ankor	ankor
अंगारक	angarak	angarak
अंग्रज़ी	angaaji	angraji
अंतः	antah	antah
अंतर्मुख	antarmukh	antarmukh
अंद्राबी	andrabb	andrabi
अंधा	andha	andha
अंधापन	andhapan	andhapan
अंधेरी	andheri	andheri
अंबानी	ambani	ambani
अकरम	akarma	akram
अकापुल्को	akapploo	akapulko
अखंड	akhand	akhand
अखिल	akhil	akhil
अगवाई	agaaa	agavai
अगस्टाइन	agsttinn	augustine
अगस्ता	agasta	agusta
अग्र	agra	agr
अचंभा	achamhh	achambha
अचीवमेंट	achivhmeet	achievement
अच्छी	achchh	acchi
अच्युत	achyut	achyut
अछनेरा	achhnera	achhanera
अजमीढ़	ajmeed	ajmeedh
अजहर	ajahar	azhar
अजित	ajit	ajit
अज्ञात	agyat	agnat
अटकता	atkata	atakta
अटके	atke	atke
अटवाल	atwal	atwal
अट्टहास	attahas	attahasa
अड्डों	addon	addon
अथक	athak	athak
अथर्व	atharv	atharv
अदद	adad	adad
अदाणी	adani	adani
अद्वैत	advait	advait
अद्वैतवाद	advvvtavad	advaitwad
अधिवास	adhivas	adhivas
अधीक	adhie	adhik
अध्ययनरत	adhyayarat	adhyayanarat
अनंत	anant	anant
अनंती	ananti	ananti
अनगढ़	angadh	angadh
अनचाहे	anchahh	anchahe
अनथक	anahhk	anthak
अनहोनी	anhoni	anhoni
अनावश्यक	anavaahyak	anavashyak
अनिक	anik	anik
अनीश्वरवादी	anishvavraad	anishwarwadi
अनुकूलता	anukulata	anukoltha
अनुचित	anuchit	anuchit
अनुप्रयोगों	anuprayogon	anuprayogi
अनुरीत	anurett	anureet
अनूठी	anuthi	anuthi
अनूदित	anudit	anudit
अन्याय	anyaya	anyaay
अपनानी	apnann	apnani
अपरिवर्तनशील	aparivaraashil	aparivartanshali
अपरिहार्य	aparirryy	apariharya
अपवर्तित	apvartit	apavartit
अपारदर्शी	aparaarhsh	apardarshi
अफरोज	afroge	afroj
अफ्रीका	afrika	africa
अब्बासी	abbass	abbasi
अभिमत	abhimat	abhimat
अभिशाप	abhishap	abhishap
अभी	abhi	abhi
अमझेरा	amjhera	amjhera
अमरगढ़	amargarh	amargarh
अमरपाल	amarpal	amarpal
अमरोही	amrohi	amrohi
अमानत	amanat	amanat
अमानती	amantt	amanati
अमावस्या	amaaasya	amavasya
अमित	amit	amit
अमिताव	amitav	amitav
अमुक	amuk	amuk
अमोघ	amogh	amogh
अम्बानी	ambaai	ambani
अयोध्यानाथ	ayodhaanath	ayodhyanath
अरदास	ardas	ardas
अरबाब	araba	arbab
अराउंड	araund	around
अर्जेंट	argent	urgent
अर्थ	arth	arth
अर्थक्वेक	arthkavek	earthquake
अर्थों	arthon	arthon
अर्पित	arpit	arpit
अर्यमा	arymma	arymaa
अलंकार	alankar	alankar
अलंकारों	alankaron	alankaaron
अलगाववादी	algaaavaai	alagavavadi
अलाइव	alaie	alive
अलायंस	alayanc	alance
अलिंद	alind	alind
अली	ali	ali
अलोंसो	alonso	alonso
अल्फ़ाबेट	alfabate	alphabet
अल्बा	alba	alba
अवंतिपुर	avantipur	avantipur
अवरु	avruu	avaru
अवरोधक	avrodhak	avarodhak
अवर्णता	avarnaaa	avarnata
अवशिष्ट	avahhisht	avshisht
अवस्थाएं	avashhaeen	avasthaayen
अवि	avi	avi
अविका	avika	avika
अविरल	aviral	aviral
अविश्वसनीय	avishvasniiy	avishvaasniy
अवीवा	aviva	aviva
अवैज्ञानिक	avaagyanii	avaigyanic
अशक्तता	ashkktta	ashaktataa
अशरफी	ashrafi	ashrafi
अशरीरी	ashrrei	ashriri
अश्वत्थ	ashwatth	ashvtth
असमान्य	asamanya	asamany
असामंजस्य	asamanaayya	asamanjasy
असुरक्षित	asurashhit	asurakshit
असेट	asset	asset
अस्वभाविक	asbabaavkk	asvabhavik
अहिरौली	ahirali	ahirauli
आइटम	itom	item
आइटम्स	itom	items
आइडल	idol	idle
आइसीसी	icc	icc
आइसो	ico	iso
आईपीसी	ipc	ipc
आईपैड	ipp	ipad
आईरिस	irrsi	iris
आउंस	ounc	ounce
आकाश	aaaash	aakash
आके	aake	aake
आखेट	aakhet	aakhet
आगत	aggtt	aagat
आगमन	agmaan	aagman
आग़ा	aga	aagaa
आगाशे	agashe	aagaashe
आजमाना	aajmaaa	aajmana
आटा	aata	aata
आत्माएं	atmmayn	aatmayen
आदान	aadan	aadaan
आधारित	aadharit	aadhaarit
आधीन	aahhen	aadhin
आधुनिक	aadhunik	aadhunik
आनद	aaaa	aanad
आपका	aapka	aapka
आपदाएं	aapdayen	aapadaaaen
आबंटित	aabnttit	aabantit
आबरू	abaru	aabru
आमदन	aamdan	aamdan
आमदनी	aamaan	aamdani
आमदी	aamii	aamdi
आमोद	amod	amod
आयेंगे	aayenge	aayenge
आयोजक	aayojak	aayojak
आरओ	aaro	ro
आरपी	rp	rp
आराम	aram	aaram
आरुषि	aauushi	aarushi
आर्टरी	artory	artery
आर्डर	order	order
आर्य	arya	arya
आर्यिका	aayika	aryika
आर्यो	aryo	aarya
आर्यों	aryon	aaryan
आलसी	lls	aalsi
आलोचक	aalochak	aalochak
आलोचकों	aalcchkkon	aalochakon
आल्हा	aaha	aalha
आवाज़ें	aaaajen	aawaazen
आवाज़ों	aaaaoon	aawajon
आविष्कार	aavishkar	aavishkaar
आवृत्ति	aavrtti	aavriti
आवृत्तियों	avvittiyon	aavritiyon
आशंका	asshanka	aashanka
आश्रितों	ashhriton	aashriton
आसान	asaan	aasan
आस्तिक	aastik	astik
आस्तीन	aastin	aasteen
आह्नान	ahhnan	aahnaan
इंग्लैंड	englann	england
इंजिनियर	engineer	engineer
इंट्रोडक्शन	intordatton	introduction
इंश्योरेंस	inshoonens	insurance
इअर	err	ear
इआन	enn	eon
इकट्ठा	ikathha	ekattha
इकठ्ठी	ikatthi	ekatthi
इकाई	ikaa	ikai
इकाईयों	ikaiyon	ekaeyon
इकोनोमिक	economic	economic
इक्वाडोर	ikaador	ecuador
इक्विटीज	equvttes	equities
इजाजत	ijaajat	ijaajat
इनहेलेशन	inhalation	inhalation
इबीजा	ebija	ibija
इमेजिंग	emaming	imaging
इम्युन	immun	immune
इलाइची	ilaccci	elaichi
इलाज	ilaaz	ilaaj
इशाक	ishak	ishaak
इशारा	ishara	ishaara
इशिता	ishita	ishita
इष्ट	isht	isht
इस्तीफे	istife	istife
ईए	aa	ea
ईटर	etor	eater
ईमेल	imal	email
ईमेलों	imalon	emailon
ईवनिंग	evannnng	evening
ईष्ट	isht	east
ईसाइयों	isaiyyon	isaaiyon
उखरुल	ukhuru	ikhrul
उछालने	uchhaaan	uchhalne
उज़्बेक	ujbee	uzbek
उठने	uthaee	uthne
उठाकर	uthaaka	uthakar
उठापटक	uthataaa	uthapatak
उठें	uthen	uthen
उड़ान	udaan	udaan
उड़ाना	udana	udana
उड़ाने	udaan	udaane
उड़ानें	udaaen	udanen
उड़ानों	udanon	udanon
उतने	utnn	utane
उत्तरा	uttara	uttra
उत्पन	utpan	utpan
उदंत	udant	udant
उदघोष	udghosh	udghosh
उदर	udar	udar
उदा	uda	uda
उदाकिशुनगंज	udakishhinann	udakishunganj
उनतीस	untis	untees
उनियाल	uniyal	uniyal
उपद्रवियों	updraviyon	upadraviyon
उपद्रवी	updravi	updravi
उपद्रवों	updravon	upadrawon
उपनेता	upneeta	upneta
उपभोक्ता	upbhokta	upbhokta
उपलक्ष्य	upalkshya	uplaksh
उपलब्ध	upalbadhh	uplabdh
उपलब्धियों	upalbbidhon	uplabdhiyon
उपलब्धी	upalbadhi	uplabdhi
उपाख्यानों	upakhyaoon	upakhyanon
उबंटू	ubantu	ubuntu
उबाल	ubaal	ubal
उभारा	ubhara	ubhara
उमानाथ	umanath	umanath
उमेश	umesh	umesh
उर्फ	urf	urf
उर्वरकों	urvaraoon	urvarakon
उर्वरता	urvaraaa	urvarata
उलटे	ultt	ulte
उलाहना	ulahana	ulahna
उलेमा	ulema	ulema
उलेमाओं	ulemaon	ulemaon
उसक	usak	usak
उसकी	usaii	uski
उसमें	usmei	usmein
उसी	usi	usi
उस्तरा	ustra	ustara
ऊर्ध्व	urddav	udharv
ऊष्मा	ushma	ushma
ऋषिकुल	rishikul	rishicool
एंजाइम	angiem	enzyme
एंटोन	antone	anton
एंटोनी	antony	antony
एंडोमेट्रियल	andomariil	endometrial
एंड्रियास	andrias	andreas
एएलएस	lls	als
एएसआई	asi	asi
एकसाथ	eksathh	eksaath
एकाकी	ekaak	ekaki
एक्सएम	xmm	xm
एगमोर	agmor	egmore
एजे	aje	aj
एजेंडे	agende	agende
एडीपी	edp	adp
एडेन	aden	adain
एड्डी	addi	addi
एपीजे	apg	apj
एफटीआईआई	ftti	ftii
एबट	abt	abbott
एबीवीपी	abv	abvp
एबोट	abott	abbott
एमटीए	mta	mta
एमटेक	mmet	mtake
एमरल्ड	emarld	emerald
एमिल	emil	emil
एमी	mmi	amy
एयरवे	ayraev	airway
एरर	erao	error
एरिका	erica	arica
एरोबिक	aarobic	aerobic
एलटीई	lti	lti
एलर्जिक	allargic	allergic
एलिमिनेटर	eliminator	eliminator
एलियंस	elianns	alliance
एशियन	asionn	asian
एसएफसी	sfc	sfc
एसके	ss	sk
एसपीएफ	spf	spf
एसोसिएशन	association	association
एस्टर	aster	astar
एस्थेटिक	asthatic	asthetic
एस्फाल्ट	aspalt	asfalt
एहसास	ehsaas	ahsaas
एेसा	essa	aisa
ऐंठ	eithh	ainth
ऐंठे	eitthe	enthe
ऐठन	athan	aithan
ऐल	ail	ail
ऐल्प्स	alps	alaps
ऐसे	aise	aise
ऑक्साइड	oxyid	oxide
ऑक्सी	oxi	oxy
ऑफर्स	offerce	offers
ऑफशोर	offhore	offshore
ऑफिशियल	official	official
ओकलाहोमा	oklahooa	oklahoma
ओक्लाहोमा	ollahoha	oklahoma
ओत	ot	ot
ओपेल	opel	opel
ओब्रायन	obryaan	obrayan
ओरण	oran	oran
ओरियन	orion	orion
ओलावृष्टि	olavrishti	olavrishti
ओवम	ovam	ovum
ओशनिक	oshiic	oceanic
ओसाका	osaka	osaka
औचित्य	auchitya	auchity
औद्योगिकरण	audhooiiaaan	audhyogikaran
औरंगाबाद	aurangabad	aurangabad
औरोरा	aurora	aurora
औलख	aulahh	aulakh
कंकड़	kankad	kankad
कंकर	kankar	kankar
कंगन	kangan	kangan
कंजंक्शन	conmanctoon	conjunction
कंटेम्पररी	contemepery	contemporary
कंठहार	kanthhha	kanthhar
कंपोजर	compower	composer
कंबलों	kambalon	kambalon
कंसलटेंट	consaltant	consultant
कक्कड़	kakkad	kakkad
कच्चे	kacche	kacche
कटरा	kataa	katra
कटलरी	katalri	cutlery
कटासराज	katasaraj	katasaraj
कठफोड़वे	kathofawe	kathfodave
कठोर	kathor	kathor
कणिका	kanika	kanika
कत्थई	kathha	kathai
कनवेंशन	convension	convention
कनाल	kanal	kanal
कनिंघम	kaningham	kaningham
कनिष्ठिका	kanishhitak	kanishthika
कन्याएं	kanyayen	kanyaayen
कन्वेंशन	convention	convention
कन्वोकेशन	convocation	convocation
कप	kap	cup
कपड़ा	kapada	kapda
कपड़ो	kapddo	kapdo
कपिंग	kapsing	kaping
कपोलकल्पना	kapoolappaan	kapolkalpana
कबड्डी	kabdddi	kabaddi
कब्र	kabr	kabr
कब्रें	kabren	kabren
कब्रों	kabron	kabron
कमज़ोर	kamjor	kamjor
कमतर	kamttr	kamtar
कमलजीत	kamlajee	kamaljeet
कमाऊ	kamau	kamau
कमाते	kamate	kamate
कमेरे	camerr	kamere
करंज	karanj	karanj
करंजिया	karanjiya	karanjiya
करघे	karghe	karghe
करछना	karchhaaa	karchhana
करना	karna	karna
करपात्री	karpatri	karpatri
करम	karam	karam
करूर	karur	karoor
कर्नाटका	karnatak	karnataka
कर्वी	karvi	karvi
कलमें	kalmen	kalmen
कलराज	kalraj	kalraj
कलिका	kalica	kalika
कल्पनाओं	kalpanaon	kalpanaon
कव्वालियों	kavvaliyon	kavvaliyon
कव्वाली	kavwali	kavvali
कष्टों	kashton	kashton
कसरत	kasartt	kasrat
कसारा	kasara	kasara
कसीदा	kasida	kasida
कहने	kahan	kahane
कहलाया	kahlaya	kahlaya
कहानियों	kahaniyon	kahaniyon
क़िले	kile	kile
कांजी	kanji	kanji
कांट	kont	kant
कांति	kanti	kanti
काकू	kaku	kakoo
कागज़	kagaj	kaagaj
काजी	kaji	kaji
काजू	kajo	kaju
कापड़ी	kapadi	kapdi
कामराज	kamraj	kamraj
कामोत्तेजना	kamotteejana	kamottejna
कायलाना	kaylana	kaylana
कार्की	karki	karki
कार्तिक	kartik	kartik
कार्यकर्ताओं	karyakartoon	karyakartaon
कार्यभार	karyabhar	karybhar
कार्यरत	karyarat	karyrat
कालपी	kalpi	kalpi
कालिका	kalika	kalika
कालीघाट	kalighat	kalighat
काल्डवेल	kaldwel	coldvel
काव	kav	kaav
काश्त	kasht	kasht
कासिम	kasim	kasim
कासिमाबाद	kasimmbad	kasimabad
किया	kiya	kiya
किलियन	killian	kiliyan
किल्लत	killat	killat
किल्ली	kilhi	killi
किसानी	kisani	kisani
किसानों	kisanon	kisanon
कीड़े	kide	kide
कीनोट	keoot	kinote
कीरतपुर	kiettpur	kiratpur
कुंडल	kundal	kundal
कुंडलियाँ	kundaliyan	kundaliyan
कुत्ता	kutta	kutta
कुपोषित	kopoohit	kuposhit
कुमाऊ	kumau	kumau
कुमावत	kumavat	kumawat
कुराल	kural	kural
कुर्मी	kurmi	kurmi
कुर्सियों	kursiyon	kursiyon
कुश	kush	kush
कुषाण	kushan	kushaan
कुसुमलता	kusumata	kusumalataa
कूट	kott	koot
कृतिका	kritika	kritika
केपीओ	cpo	kpo
कैंटरबरी	canterbbrr	canterbury
कैंडिडेट	candidate	candidate
कैटरीना	caterina	katrina
कैटलिन	catlin	caitlyn
कैडमियम	cadmimm	cadmium
कैथोलिक	catholic	catholic
कैथोलिकों	catholikon	catholicon
कैपेसिटर	cappcator	capacitor
कैरेट	carert	carat
कैविटी	cavity	cavity
कैवेलरी	cavellrry	kaivelari
कॉम्प्लेक्स	compexles	complex
कोच्चि	koccci	kochi
कोरिडोर	coridor	corridor
कोरोला	corola	korola
कोलन	colan	caolan
कोलिंग	colling	calling
कोलोराडो	colorado	colorado
कौशल	kaushal	kaushal
कौशलता	kaushllaa	kaushalata
कौशाम्बी	kaushmmbi	kaushambi
क्यूट	cyut	cute
क्यूब	kuue	cube
क्यूबेक	kyubeq	quebec
क्यूब्स	cyube	cubes
क्रांतियों	krantiyon	krantiyon
क्रिक	crick	cric
क्रिकेट	crickt	cricket
क्रिकेटर	kricetor	cricketer
क्रिकेटिंग	cricktting	cricketing
क्रियायोग	kriyayog	kriyayog
क्रिश्चयन	christhan	christian
क्रूगर	croggr	kruger
क्रेग	crag	craig
क्रैडल	credal	cradle
क्रोम	crom	chrome
क्लांइट	clanit	client
क्लाक	clac	clock
क्लासें	classen	classen
क्लासों	classon	classon
क्ले	kley	clay
क्लेरिस	claris	claris
क्वांटिको	quanticoo	quantico
क्वींस	queens	queens
क्षितिज	khiitij	kshitij
क्षीण	khien	kshin
क्षेत्रों	kshetorn	kshetron
खंडा	khanda	khanda
खचाखच	khachakha	khachakhach
खजराना	khajrana	khajarana
खटकती	khataati	khatakati
खट्टापन	khattapan	khattapan
खत	khat	khat
खनि	khani	khani
खनिक	khanik	khanik
खनिकर्म	khanikarm	khanikarm
खपत	khapat	khapat
खरिया	khariya	khariya
खलनायक	khalaayak	khalnayak
ख़ासकर	khassak	khaskar
ख़ासतौर	khaastaur	khastaur
ख़ैबर	khabbur	khaibar
खाएं	khayen	khaein
खाते	khate	khate
खाल	khaa	khal
खिंचकर	khinchaar	khinchkar
खिलाना	khilana	khilana
खींचकर	khinchaar	khinchkar
खुदा	khuda	khuda
खुदाई	khudai	khudai
खुरपका	khurpaka	khurpaka
खुरासान	khurassan	khurasan
खुशियां	khushiyan	khushiyan
खेने	khene	khene
खैनी	khaini	khaini
खैराती	khairati	khairati
खोईखोई	khokhoo	khoikhoi
खोया	khoya	khoya
गंगरेल	gangrrel	gangrel
गंगाजल	gangajal	gangajal
गंडकी	gandaki	gandki
गंध	gandh	gandh
गए	gay	gaye
गजरा	gajra	gajra
गडकर	gadkar	gadkar
गणपति	ganppaii	ganapati
गतिशील	gatishil	gatishil
गतिशीलता	gatishilata	gatishilata
गदाधर	gadadhar	gadadhar
गम्मत	gammat	gammat
गया	gaya	gaya
गरीबी	garibi	garibi
गर्जना	garjana	garjana
गलगंड	galgand	galgand
गहमागहमी	gahmagahami	gahmagahmi
गांगुली	ganguli	ganguly
गांठ	gannh	ganth
गांठे	ganthe	ganthe
गांठें	gantheen	ganthen
गांठों	ganthon	ganthon
गाएं	gaeen	gaen
गाज़ी	gazz	gazi
गाजीपुर	gajipur	gazipur
गायत्री	gayatri	gayatri
गिड़गिड़ाते	giigidate	gidgidate
गिनते	gintt	ginte
गिरकर	girkar	girkar
गिरजाघर	girjaghar	girjaghar
गिरजाघरों	girjagharon	girjagharon
गिरती	girtt	girti
गिरीश	girish	girish
गुआन	guann	guan
गुजार	gujar	gujar
गुजारता	gujarta	gujarta
गुजारते	gujarae	gujarte
गुजारना	gujarna	gujarna
गुजारा	gujara	gujara
गुजारे	gujare	gujare
गुट्टा	gutta	gutta
गुठलीदार	guthllddar	guthalidar
गुदना	gudna	gudna
गुमान	guman	guman
गुलशन	gulshan	gulshan
गूंगा	gunga	gunga
गृहनगर	grihangar	gruhnagar
गैलेक्सियों	galaxisoon	galaxion
गोचर	gochar	gochar
गोदारा	godara	godara
गोपीचंद	gopichand	gopichand
गोमके	gomke	gomke
गोयल	goil	goyal
गोस्वामी	goswami	goswami
गौमुख	gaumukh	gaumukh
गौमूत्र	gaumutra	gaumutra
ग्रंथियां	granthiyan	granthiyan
ग्रंथियों	granthiyon	granthiyon
ग्रीस्ट	greest	greest
ग्रेग	grag	greg
ग्रेनाइट	grenntte	granite
ग्रैंडसन	grandsoon	grandson
ग्रॉस	gross	gross
घटाटोप	ghatatop	ghatatop
घटाया	ghataya	ghataya
घनाकार	ghanakar	ghanakar
घबराहट	ghabrahat	ghabrahat
घासी	ghasi	ghasi
घिसाई	ghisai	ghisai
घिसी	ghisi	ghisi
घिसे	ghise	ghise
घुमक्कड़ी	ghumakkadi	ghumakkadi
घुमक्कड़ों	ghumakkadon	ghumakkadon
घुमाण	ghuman	ghuman
घूंसा	ghunsa	ghunsa
घोंघा	ghongha	ghongha
घोंटने	ghontane	ghontane
घोट	ghot	ghot
घोड़ी	ghodi	ghodi
घोस्ट	ghost	ghost
चंगुल	changul	changul
चंद	chand	chand
चंदन	chandan	chandan
चंदू	chandu	chandu
चंदों	chandon	chandon
चंद्रबली	chandrabali	chandrabali
चंद्रमाओं	chandramaon	chandramaon
चकत्ते	chakatte	chaktte
चक्कर	chakkar	chakkar
चक्षु	chakshu	chakshu
चटगांव	chatgann	chatgaon
चढ़ने	chadhne	chadhne
चतुर्दिक	chaturdik	chaturdik
चतुष्कोणीय	chatushkoiiy	chatunshkoniy
चन्ना	channa	channa
चबाते	chabaae	chabate
चबूतरे	chabutaee	chabutare
चमकना	chamaana	chamakna
चरस	charas	charas
चरित	charit	charit
चर्चा	charcha	charcha
चर्चाओं	charchaon	charchaon
चलेंगे	chalenge	chalenge
चहुंओर	chahunor	chahunor
चांवल	chanwal	chanval
चाचाजी	chachaji	chachaji
चादर	chadhar	chadar
चादरों	chadron	chadron
चान	chan	chan
चानन	chanan	chanan
चापलूसी	chapluls	chaplusi
चायल	chayal	chayal
चार	char	char
चारों	charon	charon
चार्ज	charg	charge
चार्ट	chart	chart
चार्टों	charton	charton
चार्ट्स	charts	charts
चालित	chalit	chaalit
चिकित्सक	chikitsak	chikitsak
चिकित्सकों	chikitsakon	chikitsakon
चिखली	chikhali	chikhali
चिट्ठी	chitthi	chitthi
चिठ्ठी	chitthi	chithhi
चिडचिडापन	chicchidapan	chidchidapan
चिड़चिड़ापन	chidchidapan	chidchidapan
चिढ़ते	chidhtte	chidhate
चित्रकार	chitrkkar	chitrkar
चिपकने	chipkane	chipakane
चिमटी	chimti	chimti
चिल्लाने	chillane	chillane
ची	chi	chi
चुका	chuka	chuka
चुने	chune	chune
चूनर	chunar	chunar
चेंज्ड	chenge	changed
चेट्टी	chetti	chetti
चेन्नई	chennai	chennai
चेरो	chero	chero
चेस्ट	chest	chest
चैंपियनशिप	champioiniih	championship
चोर	chor	chor
चोरों	choron	choron
चौक	chauk	chauk
चौका	chauka	chauka
चौकियां	chaukiyan	chaukiyan
चौकी	chauki	chauki
चौखटे	chaukhate	chaukhate
चौगुनी	chauguni	chauguni
चौड़ा	chauda	chauda
चौदहवां	chaudhaaaa	chaudahavan
चौपाटी	chaupati	chaupati
चौपाल	chaupal	chaupal
चौरई	chauri	chaurai
चौसिंगा	chausinga	chausinga
छगन	chhagan	chhagan
छबि	chhabi	chhabi
छल्ला	chhalla	chhalla
छवियाँ	chhaviyan	chhaviyan
छवी	chhavi	chhavi
छह	chhah	chhah
छहों	chhahon	chhahon
छाई	chhae	chhai
छागला	chhaagaa	chhagla
छाजन	chhajan	chhajan
छाती	chhaati	chhati
छापेमार	chhaapmar	chhapemar
छींक	chhenk	chhink
छींके	chhikk	chenkein
छुडाने	chhudane	chhudane
छुपकर	chhupkar	chhupkar
छुपता	chhupaaaa	chhupta
छुरा	chhura	chhura
छुरी	chhuri	chhuri
छुरे	chhure	chhure
छूटने	chhutan	chhutane
छेत्र	chhetra	chhetr
छेत्री	chhetrr	chhetri
छै	chha	chai
जगाएगा	jagaeygaaa	jagaega
जजों	jajon	jajon
जड़	jad	jad
जड़ित	jadit	jadit
जड़ें	jaden	jadein
जतरा	jataa	jatara
जताती	jatati	jatati
जनगणना	janganaa	janganana
जनजागरण	janaaggaa	janjagran
जनवरी	janvari	january
जनहानि	janhaan	janahaani
जमाती	jamati	jamaati
जमाया	jamaya	jamaya
जमुई	jamui	jamui
जय	jay	jai
जयदयाल	jaidayaa	jaydayal
जयबाण	jaybban	jaiban
जयललिता	jailalita	jayalalita
जरख	jarakh	jarakh
जर्दा	jarda	jarda
जलगति	jalgati	jalgati
जलते	jaltt	jalte
जलभराव	jalbharav	jalbharav
जलवायु	jalvayuu	jalvayu
जलेसर	jalasar	jalesar
जसमीत	jasmeet	jasmeet
जस्सी	jassi	jassi
ज़माना	jamana	zamana
ज़लज़ले	jajjale	jaljale
ज़ी	ze	zee
ज़ुबान	juban	jubaan
जाँच	jaanch	janch
जागृति	jagriti	jagriti
जाजमऊ	jajmau	jajamau
जात	jaat	jaat
जातक	jataa	jaatak
जातकों	jataaon	jatakon
जातियों	jaatiyon	jaatiyon
जानकारों	jankaaon	jankaron
जानम	jaaaa	jaanam
जायके	jayake	jaayke
जावर	jawer	zawar
जिंग	jing	jing
जिन	jenn	jin
जिनी	jinn	jini
जिनीवा	jineva	geneva
जिप्सी	jipsi	gypsy
जिम्मे	jimme	jimme
जिया	jiya	jiya
जीआईसी	gic	gic
जीआर	gr	gr
जीएम	mm	gm
जीएसएम	gsm	gsm
जीतोड़	jittod	jitod
जीन	jeen	jeen
जीनों	jeenon	jeenon
जीपनी	jipnn	jipani
जीयो	jee	jeeyo
जीरा	jira	jeera
जीवंत	jevant	jivant
जीवन	jevvan	jeevan
जीवनशैली	jieaashaal	jivanshaili
जीवनियां	jivaniyan	jeevniyaan
जीवराज	jevraj	jivraj
जुए	juy	jua
जुटी	juti	juti
जुड़ाई	judai	judaai
जुदाई	judai	judaai
जुनून	junun	junoon
जुनूनी	jununi	junooni
जुबेर	juber	juber
जुराब	juraa	jurab
जुलाहों	julahon	julaahon
जुल्मों	julmon	julmon
जूड	juo	jud
जूनागढ	junagadh	junagarh
जूनियर	junior	junior
जूलूस	juluus	juloos
जेठा	jetha	jetha
जेनर	jennr	jenner
जेनरिक	generic	generic
जेनरेट	generate	generate
जेनी	jenny	jenny
जेम्स	jemes	james
जेरेमी	geremi	jeremy
जेरोम	gerom	jerome
जैक्स	jax	jacks
जैन	jain	jain
जैने	jaine	jaine
जैनों	jainon	jainon
जैरी	jairy	jerry
जैस्पर	jaiper	jasper
जॉगिंग	jogging	jogging
जॉनसन	jonsoon	johnson
जॉब्स	jobs	jobs
जोकि	joki	joki
जोखिम	jokhim	jokhim
जोड़ता	jodta	jodta
जोड़ियों	jodiyon	jodiyon
जोड़ो	jodo	jodo
जौं	jaun	jaun
ज्ञातव्य	gyataaya	gyatavya
ज्ञापित	gyapit	gyapit
ज्योतिबा	jyotiba	jyotiba
ज्वाइंट	wwint	joint
ज्वार	jwar	jwar
ज्वारों	jwaron	jvaaron
ज्वेलर्स	jeawelors	jewellers
झ	jha	jh
झलकती	jhalaktt	jhalkati
झल्ला	jhalla	jhalla
झांकना	jhankana	jhankana
झील	jheel	jhil
झीलों	jhelonn	jhilon
झुठला	jhuthaaa	jhuthla
झुठलाने	jhuthalan	jhuthlane
टंकार	tankar	tankar
टकरा	takra	takra
टकरावों	takrrvoo	takravon
टपकती	tapkati	tapakti
टाइम	time	time
टाइमर	timer	timer
टाऊ	to	tau
टापुओं	tapuon	tapuon
टायर्ड	tird	tied
टार्च	tarch	tarch
टिक	tick	tik
टिप	tip	tip
टिप्पणीकार	tippanikar	tippanikar
टिवोली	tiwoli	tivoli
टीकमगढ़	tikamgarh	tikamgarh
टीकों	tiekoo	tikon
टु	tu	two
टेंशन	tention	tension
टेनिस	tenis	tennis
टेस्ट	test	test
टेस्टिंग	testing	testing
टैनिन	tanin	tainin
टैनिस	tanii	tennis
टैबू	tabu	taboo
टॉनिक	tonic	tonic
टोंगा	tonga	tonga
टोका	toka	toka
ट्यूजडे	tusddy	tuesday
ट्यूनिंग	tunnnng	tuning
ट्यूबरक्यूलोसिस	tuwurccoo	tuberculosis
ट्रक	truk	truck
ट्रांजिस्टर	trangister	trangistor
ट्रान्सफर	transfer	transfer
ट्रिब्युनल	tribunal	tribunal
ट्रिब्यूनल	tribunal	tribunal
ट्रुथ	truth	truth
ट्रेडेड	traded	traded
ट्रेबल	trable	trabal
ट्रैप	trap	trap
ट्रॉट	trot	trott
ठक्कर	thakkar	thakkar
ठहरने	thaharne	thaharne
ठिकाने	thikane	thikane
ठुमरी	thumari	thumri
ठेंगा	thenga	thenga
डगलस	daggas	daglas
डभरा	dabhra	dabhara
डभोई	dabhii	dabhoi
डम	dame	dum
डराते	darate	darate
डरावनी	daravani	dravani
डाउन	down	down
डाक	daa	dak
डाका	daka	daka
डाबी	dabi	dabi
डाबोलिम	dabolim	dabolim
डायनासोर	diansore	dinosaur
डायरीज	diares	diaries
डिट	dit	dit
डिप्थीरिया	dipthiiaa	diphtheria
डीई	dee	de
डीलरशिप	dellership	dealership
डीवीसी	dvc	dvc
डुबाना	dubana	dubana
डुबोना	dubona	dubona
डुलने	dulne	dulne
डूंगरपुर	dungarpur	dungarpur
डूबना	dubnn	dubana
डेंजरस	dengorss	dangerous
डेजी	deji	daisy
डेप्युटी	deputty	deputy
डेविडसन	devidison	devidson
डेवी	devi	davey
डेस्टिनेशन	destination	destination
डैटसन	datsoon	datsun
डैडी	dadd	daddy
डॉर्क	dork	dark
डोज	dos	dose
डोमेनिक	domenic	domenic
डोरंडा	doranda	doranda
डोलने	dolane	dolne
ड्युअल	duwl	dual
ड्यूक	duue	duke
ड्रामे	drame	drame
ड्रेजर	dressor	drager
ढकाल	dhakal	dhakaal
ढले	dhale	dhale
ढूंढ	dhundh	dhoondh
ढूंढता	dhuonhha	dhoondhata
ढूंढी	dhoondh	dhundhi
तंजावुर	tanjavur	tanjavur
तंत्र	tantra	tantra
तंत्रिकाओं	tantrikaon	tantrikaon
तंत्रों	tantron	tantron
तगड़े	tagade	tagade
तड़ीपार	tadipar	tadipaar
तनी	tani	tani
तपन	tapan	tapan
तरफा	tarfa	tarfa
तरबगंज	taraaganj	tarabganj
तरस	taras	taras
तराश	tarash	taraash
तराशे	tarashe	tarashe
तरीको	tariko	tariko
तर्क	tark	tark
तर्कवाद	tarkwad	tarkvaad
तर्कों	tarkon	tarkon
तलबगार	talbagar	talabgaar
तलवे	talve	talve
तलवों	talvon	talvon
तहखाना	tahkhana	tahkhana
तांता	tanta	tanta
तांबे	tambe	tambe
ताजा	taja	taaza
तानसेन	tansen	tansen
तापमानों	tapmanon	tapmanon
ताप्ती	taati	tapti
ताराबाई	tarabai	tarabai
तासीर	taaser	tasir
ताहि	tahi	tahi
तिकोने	tikone	tikone
तिरूपति	tirupati	tirupati
तिवारी	tivari	tiwari
ती	ti	ti
तीर	teer	teer
तीरों	teeon	teeron
तीर्थाटन	tirthatan	tirthatan
तुंगनाथ	tunganath	tungnath
तुगलक	tugaak	tuglak
तुगलकाबाद	tugalkaabad	tughlakabad
तुगलकी	tugaaki	tugalaki
तुफैल	tufall	tufail
तेजाजी	tejaji	tejaji
तेजी	teji	teji
तेल	tel	tel
तेलों	telon	telon
तो	to	to
तौल	taul	taul
त्यौहार	tyahaha	tyohaar
त्यौहारों	tyahaaron	tyauharon
त्रिजटा	trijta	trijata
त्रिया	triya	triya
त्रैमासिक	trammssii	trimasik
त्से	tsas	tse
थकी	thaki	thaki
थर्टी	thurti	thirty
थाणे	thane	thane
थानवी	thanav	thanvi
थिएटरों	theteeoon	theateron
थिएटर्स	thetters	theaters
थियेटर	thiatter	theater
थियेटरों	thiaetaron	theateron
थियेटर्स	thiaetos	theaters
थिरके	thirke	thirke
थीफ	thiff	thief
थेन	then	then
थेनी	theni	theni
थैली	thaili	thaili
थैले	thaile	thaile
दंग	dang	dang
दंगा	danga	danga
दंगों	dangon	dangon
दंपति	danpati	danpati
दंपतियों	dampatioon	dampatiyon
ददरेवा	dadreva	dadreva
दमोह	damoh	damoh
दरदरा	dardara	dardara
दरमियान	darmiyan	darmiyan
दर्जनों	darjanon	darjanon
दर्प	darp	darp
दर्रा	darra	darra
दलबदल	dalbadal	dalbadal
दली	dali	dali
दस्ताना	dastana	dastana
दस्तावेज	dastavej	dastavej
दहन	dahan	dahan
दहल	dahal	dahal
दा	da	da
दाखिल	daakhil	dakhil
दाखिले	dakhile	dakhile
दाता	data	daataa
दादरी	dadaii	dadari
दानशील	daashie	danshil
दाभोलकर	dabhokakr	dabholkar
दामले	damme	damle
दायित्व	dayitv	dayitv
दायित्वों	daaitvon	dayitvon
दारूल	darul	darul
दाव	davv	daav
दाह	dahh	daah
दिखला	dikhla	dikhla
दिखाइये	dikhaye	dikhaiye
दिखाई	dikhai	dikhaai
दिखाईं	dikhayen	dikhaaee
दिखायी	dikhayi	dikhayi
दिखार्इ	dikharr	dikhaai
दिता	dita	ditaa
दिनांक	dinank	dinank
दिरहम	dirhham	dirham
दिलाये	dilayy	dilaye
दिवानी	diwani	diwani
दिव्य	divya	divya
दिव्यता	divyata	divyata
दिव्या	divya	divya
दीपन	dippan	deepan
दीपसिंह	dipsingh	deepsingh
दीपिका	dipika	deepika
दीया	diya	diya
दुकानों	dukanon	dukaanon
दुक्के	dukke	dukke
दुखन	dukhan	dukhan
दुखित	dukhit	dukhit
दुखियों	dukhiyon	dukhiyon
दुखों	dukhon	dukhon
दुभाषियों	dubhashiyon	dubhashiyon
दुर्गुण	durgun	durgun
दुर्घटना	durghataaa	durghatna
दुर्नीति	durniti	durniti
दुर्भिक्ष	durbhiksh	durbhiksh
दुविधाएं	duvidhayen	duvidhaen
दूने	dune	dune
दूरदर्शन	dordarshan	doordarshan
दृढ़	drudh	dradh
देखोगे	dekhoge	dekhoge
देनेवाली	denevali	denevali
देवनार	devnar	deonar
देवापुर	devapur	devapur
देवी	devi	devi
देवीसिंह	devisingh	devisingh
देशकाल	deshkaa	deshkaal
देशके	deshke	deshke
देसाई	desaa	desai
दोगे	doge	doge
द्वादश	dwaaash	dvadash
द्विवेदी	dwivedi	dwivedi
धंधे	dhandhe	dhande
धंधों	dhandhon	dhandhon
धकेलते	dhakelate	dhakelte
धटना	dhatna	dhatna
धनकुबेर	dhankuber	dhankuber
धनधान्य	dhandhanya	dhandhanya
धमकाता	dhamkata	dhamkata
धम्म	dhamm	dhamm
धम्मा	dhamma	dhamma
धर्मनाथ	dharmnath	dharmnath
धर्मराज	dharmaaj	dharmraj
धर्मेश	dharmesh	dharmesh
धस्माना	dhasmana	dhasmana
धाक	dhak	dhaak
धागा	dhaaa	dhaaga
धातुएं	dhaatuen	dhaatuein
धारक	dharrak	dharak
धारी	dhari	dhari
धुआं	dhuaa	dhuan
धुनाई	dhunai	dhunai
धुरिया	dhuriya	dhuriya
धूनी	dhunn	dhuni
धैर्यवान	dhairyavan	dhairyavaan
धोखेबाज	dhokhebazz	dhokebaaj
धोना	dhona	dhona
धोराजी	dhoraji	dhoraji
धोरों	dhoron	dhoron
ध्येयवादी	dhyayavaai	dhyeyavaadi
ध्रुपद	dhrupad	dhrupad
नंदनवन	nandanvan	nandanvan
नक्सल	naksal	naksal
नक्सलवाद	naksalaaa	naksalavaad
नक्सलियों	naksaliyon	naksaliyon
नक्सली	naksali	naksali
नगाड़ा	nagada	nagaada
नगीने	nagiee	nagine
नजरंदाज	najarandaj	najarandaaj
नजराने	najraae	najraane
नजरियों	najaiyon	najariyon
नजरों	najaron	najron
नजीब	najeeb	najeeb
नजीबाबाद	najieabad	najibabad
नजीम	najiem	najeem
नना	nana	nana
नन्हें	nanhen	nanhe
नब्ज़	nabz	nabj
नमकीन	namkenn	namkin
नरनारी	narnari	narnaari
नरभक्षी	narbakshhi	narbhakshi
नरम	naram	naram
नरमी	narmi	narmi
नरसंहार	narsanhar	narsanhar
नरसंहारों	narsanharon	narsanharon
नवंबर	navmmmar	november
नवकेतन	navketan	navketan
नवजागरण	navjagagan	navjagran
नवधा	navdha	navdha
नववधू	navaadhu	navvadhu
नवा	nava	nava
नवाते	navate	navate
नवानगर	navanagar	navanagar
नव्या	navya	navya
नसीम	nasem	nasim
नाइट्रस	nitras	nitrous
नाइनटीज	ninhtees	nineteez
नाऊ	nauu	nau
नाकाम	nakaam	nakam
नागारिक	nagarik	naagrik
नागिन	nagin	nagin
नाडेप	nadep	nadep
नानक	nanak	nanak
नानावती	nanavati	nanavati
नापने	napane	napane
नापा	napa	napa
नाम	naam	naam
नामधारी	namdhari	naamdhari
नामांकनों	namankanon	namankanon
नामावलियों	namaaaliyon	namavaliyon
नामो	namo	naamo
नायक	nayak	nayak
नाराजी	naraji	naraji
नारायणगढ़	narayangarhh	naraingarh
नासर	nasar	naasar
नाहरगढ	nahaagarh	nahargarh
निकलेगी	nikalegi	nikalegi
निकालनी	nikaalai	nikaalani
निकी	nici	niki
निकेतन	niketan	niketan
निखर	nikhar	nikhar
निखरी	nikhari	nikhari
निगर	nigar	nigar
निचला	nichala	nichala
नितियों	nitiyon	nitiyon
नित्या	nitya	nitya
निधान	nidhan	nidhaan
निपटारा	niptaaa	niptaara
नियंता	niyanta	niyanta
निया	niya	niyaa
निर्देशिका	nirdeshika	nirdeshika
निर्धारित	nirdharit	nirdharit
निर्बाध	nirbaahh	nirbadh
निवेशकर्ता	niveshkkrta	niveshakartaa
निश्चल	nishchal	nishchal
निष्णात	nishnaa	nishnaat
निष्पाप	nishpapp	nishpaap
निहलानी	nihaaani	nihalaani
निहालचंद	nihaaahhannd	nihalchand
नीचाई	nichai	nichaai
नीट	neet	neat
नीतियों	nittioon	nitiyon
नीलगाय	nillaa	nilgai
नीलाभ	neelabh	neelaabh
नुस्खे	nuskhe	nuskhe
नून	noon	noon
नूबिया	nubiya	nubiya
नृत्यशैली	nrityashli	nrityashaili
नृत्यों	nrityon	nrityon
नेको	neko	neko
नेक्टर	nector	nectar
नेग	neg	neg
नेटवर्किग	networkin	networking
नेटो	neto	neto
नेता	neta	neta
नेमो	nemo	nemo
नेल्सन	nelson	nelson
नेशंस	nethins	nations
नेहरा	nehra	nehra
नैनो	naino	nano
नैवेद्य	naivedya	naivedh
नॉमिनेट	nominete	nominate
नोकरी	nokari	nokari
नोट्स	notes	notes
नोरा	nora	nora
नोरी	nori	nori
नौनेर	nauner	nauner
नौवहन	nauvahan	nauvahan
नौशाद	naushad	naushad
पंचांग	panchang	panchang
पंजाब	panjaa	punjab
पंजाबियों	panjabiyon	punjabiyon
पंटर	panter	pantar
पकाएं	pakaen	pakaayein
पकौड़े	pakaude	pakaude
पक्षपात	pakshapa	pakshapat
पगबाधा	pagbadha	pagbadha
पगला	pagla	pagla
पचाता	pachata	pachaataa
पटककर	patkakar	patakkar
पटकथाएं	patkathaenn	patkathaayein
पटकी	patai	patki
पटरानी	patraan	patrani
पटवारी	patwari	patwari
पटाक्षेप	patakshep	pataakshep
पटिया	patiya	patiya
पडरौना	padaruna	padrauna
पड़ेगा	padega	padegaa
पढ़ा	padha	padha
पढ़ाता	padhata	padhaataa
पतीली	patili	patili
पदमावती	padmavati	padamawati
पदाधिकारी	padadhikari	padadhikari
पनपना	panpana	panpana
पनामा	panama	panama
पनीर	panie	paneer
पम्मी	pammi	pammi
परदेसियों	pardesiyon	pardesiyon
परदेसी	pardesi	pardesi
परवा	parva	parva
पराधीन	paraadhin	paraadheen
परिकल्पित	parikaliit	parikalpit
परिमल	parimal	parimal
परिषद	parishad	parishad
परिषदीय	parishddiy	parishadiya
परिषदों	parishadon	parishadon
परीक्षाएं	parikshayen	parikhaen
परोसने	parosane	parosne
पर्दा	parda	parda
पर्पल	parpal	purple
पलटने	paltane	paltane
पलारी	palari	palari
पले	pale	pale
पल्मोनरी	palmonari	palmonari
पल्स	pals	pulse
पश्तून	pashtonn	pashtun
पहन	pahan	pahan
पहनता	pahnaaaa	pahantaa
पहनते	pahnate	pahanate
पहनाकर	pahnakar	pahnaakar
पहनाती	pahnaai	pahnaati
पहनी	pahnn	pahani
पहनो	pahno	pahno
पहला	pahla	pahla
पहेलियां	paheliyan	paheliyan
पहेलियों	paheliyon	paheliyon
पाइड	pide	pied
पाइथागोरस	pithtgorash	pythagoras
पाखंडी	paahhandi	pakhandi
पाठशालाएं	pathhhahllayn	paathshaalaayein
पाठ्यक्रम	pathhyakra	paathyakram
पाठ्यक्रमों	pathhyakramon	paathyakramon
पापुलेशन	papulation	population
पायलट	payllat	pilot
पायलटों	paialton	piloton
पारंपरिकता	paaaaaaaiikaaa	paarampariktaa
पार्नेल	parrel	parnel
पार्लरों	parloron	parleron
पार्षद	parrsaa	parshad
पार्षदों	parrhhadon	paarshadon
पालिसी	paliii	policy
पिंटा	pinta	pinta
पिएगा	piyga	piega
पिक	pic	pick
पिकी	pikki	piki
पिक्चर	picture	picture
पिगमेंटेशन	pigmenatioon	pigmentation
पिग्स	pigs	pigs
पिछड़े	picchade	pichhade
पिज्जा	pizza	pizza
पितामह	pitamah	pitamah
पिपरा	pipra	pipra
पिपली	pipaii	pipli
पियरसन	piarsson	pearson
पियरी	piary	peary
पिसाई	pisai	pisaai
पिहानी	pihani	pihani
पीआईबी	pib	pib
पीआर	pr	pr
पीएमएल	pml	pml
पीएमओ	pmo	pmo
पीएमसीएच	pmsc	pmch
पीएसवी	psv	psv
पीकिंग	pecking	picking
पीटने	pitnn	pitne
पीडिया	pidia	pedia
पीलेपन	peleppan	pilepan
पीवी	pivi	pv
पीसा	pisa	pisa
पुतला	putla	putla
पुतलियां	putliyan	putliyan
पुतलियों	putliyon	putliyon
पुतली	putal	putli
पुतले	putal	putle
पुतिन	putin	putin
पुतुल	putul	putul
पुनर्गठन	punargathan	punargathan
पुना	puna	puna
पुराने	purane	purane
पुरू	puru	puru
पुर्जों	purjon	purjon
पुलम	pulam	pulam
पुश्किन	pushkin	pushkin
पुष्करणा	pushkarana	pushkarana
पुष्प	pushp	pushp
पुष्पा	pushpa	pushpa
पुष्पित	pushpit	pushpit
पुष्पों	pushpon	pushpon
पूंजीकरण	poonjikaaan	punjikaran
पूजापाठ	pujapaat	pujapath
पूरनपुर	puranpuu	puranpur
पूर्वाभास	purvahhas	purvabhas
पेंडुलम	pendulam	pendulum
पेग	peg	peg
पेजेज	pajes	pages
पेस	pace	pace
पेस्ट्री	pestry	pastry
पैंगोलिन	pangolin	pangolin
पैकर्ड	packord	packard
पैकेज	pacceg	package
पैकेजों	packeenn	packageon
पैम	pam	pam
पैराट्रूपर	parattopur	paratrooper
पैरानॉर्मल	peranorall	paranormal
पैराफिन	parrffin	paraffin
पैराबोला	paraabla	parabola
पॉलिमर	polimer	polymer
पॉलिशिंग	pollching	polishing
पोकर	pokar	poker
पोलिश	polish	polish
पोषित	poshit	poshit
पोस्ता	posta	posta
पौ	pau	pau
प्यादे	pyade	pyade
प्रक्रिया	prakriya	prakriya
प्रक्षेपक	prakshepak	prakshepak
प्रतिज्ञा	pratigya	pratigya
प्रतिभूतियां	pratibhutiyan	pratibhutiyan
प्रतियों	pratiyon	pratiyon
प्रतिवाद	prativad	prativad
प्रतिवादी	prativadi	prativadi
प्रतिशत	pratishat	pratishat
प्रनीत	pranit	pranit
प्रपात	prapat	prapat
प्रपातों	prapaton	prapaton
प्रबोधिनी	prabodhini	prabodhini
प्रयासरत	prayasarat	prayasarat
प्रर्दशन	praddssaon	pradarshan
प्रवत्ति	pravatti	pravatti
प्रशासनिक	prashasanii	prashasnik
प्रशासनों	prashasanon	prashaasanon
प्रशिक्षु	prashikshu	prashikshu
प्रस्तावों	prastavon	prastaavon
प्रहलाद	prahlad	prahlad
प्रहसन	prahasan	prahasan
प्रहारक	praharak	praharak
प्रह्लाद	prahlad	prahlad
प्राइवेसी	privesi	privacy
प्राक्कथन	prakkathan	prakkathan
प्राण	pran	pran
प्राणों	pranon	pranon
प्राथमिक	prathmii	prathmik
प्राथमिकता	prathmmikaa	prathmikta
प्राथमिकी	prathmmik	prathmiki
प्राध्यापकों	pradhyapakon	pradhyapakon
प्राप्त	prapt	prapt
प्राप्ती	prapti	prapti
प्रारूप	prarop	prarup
प्रियामणि	priyamani	priyamani
प्रूफ	proof	proof
प्रेक्षकों	prekshakon	prekshakon
प्रेम	prem	prem
प्रेमलता	premalta	premlata
प्रेमा	prema	prema
प्रेमी	premi	premi
प्रॉफिट	profhtte	profit
प्रॉसेसिंग	processing	processing
प्रोग्रामर्स	programers	programers
प्रोटो	proto	proto
प्रोपेलेंट	propelent	propellant
प्रौढ	praudh	praudh
प्लेन	plan	plane
फंड	fond	fund
फंडा	fanda	funda
फंडिंग	funding	funding
फंदों	fandon	fandon
फगुआ	faguua	fagua
फटने	fatane	fatane
फड़फड़ाता	fadaadaaa	fadfadata
फतेहगढ़	fatehagarh	fatehgarh
फब्ती	fabti	fabti
फरसे	farse	pharse
फरहीन	farhien	farheen
फर्थ	farth	farth
फर्मिऑन	firmin	farmion
फर्रुखाबाद	farrohhabad	farookhabad
फर्रूखनगर	farrukhanagar	farookhnagar
फलता	falta	falta
फलने	falnne	falne
फलितार्थ	falitarth	falitarth
फलीभूत	falibuut	falibhoot
फव्वारा	favvara	favvara
फव्वारे	favvare	favvare
फव्वारों	favvaron	favvaron
फ़ैसला	faisaaa	faisla
फ़ॉलो	foll	follow
फांसी	fansi	fansi
फातमा	faataa	fatma
फाफ	faff	faaf
फारसी	farsi	farsi
फार्म	farm	farm
फार्मिक	farmic	formic
फार्मूले	farmule	formulae
फार्मेसी	farmesi	pharmacy
फार्मों	farmon	pharmon
फार्म्स	forms	farms
फिंगर	finger	finger
फिक्र	fikra	fikra
फिजिशियन	phisision	physician
फिरती	firtt	firti
फिसला	fisla	fisla
फीडर	fedder	feeder
फुलाए	fulaye	fulaaye
फूर्ति	furti	furti
फूस	foos	phus
फेका	feka	feka
फेफड़ा	fefaada	fefada
फेशियल	feshiaa	facial
फैक्ट	fact	fact
फैडरल	faderal	federal
फैलकर	failkar	failkar
फैलाइए	failayy	failaaiye
फैलेगी	failegi	failegi
फॉन्ट	font	font
फोगाट	fogat	phogat
फोड़	fod	fod
फोड़ा	foda	foda
फोड़े	fode	fode
फोड़ों	fodon	fodon
फोर्टिस	fortic	fortis
फ्यूजन	fuseon	fusion
फ्यूजी	fuj	fuji
फ्रांसिस्का	fransissa	franciska
फ्रांसिस्को	fransisso	francisco
फ्रिंज	fring	fringe
फ्रेंडशिप	frendship	friendship
फ्रॉस्ट	frost	frost
फ्लिन	flin	flin
फ्लेश	flash	flesh
बंग	bang	bung
बंगबंधु	bangaandhu	bangbandhu
बंगभंग	bangbhang	bangbhang
बंगश	bangash	bangash
बंटने	bantane	bantne
बंधती	bandhtti	bandhati
बंधान	bandhan	bandhan
बंधुओं	bandhuon	bandhuon
बंबा	bamba	bamba
बकायों	bakayon	bakayon
बकौल	bakaul	bakaul
बक्सा	baksa	baksa
बक्सी	baksi	baksi
बक्से	bakse	bakse
बख्शने	bakhshan	bakhshane
बगड़	bagad	bagad
बगीची	bagiichi	bagichi
बचत	bachat	bachat
बचती	bachti	bachti
बजना	bajna	bajana
बजरंगी	bajrangi	bajrangi
बजाज	bajaa	bajaj
बटालवी	battali	batalvi
बढ़ाचढ़ाकर	badhachakhar	badhachadhakar
बढ़ाता	badhata	badhata
बढ़ाती	badhati	badhati
बढ़ायी	badhayi	badhayi
बढ़ाव	badhav	badhav
बढ़ोतरी	badhotari	badhotari
बतलाए	batlaye	batlaae
बतलाकर	bataakar	batlakar
बदलापुर	badaapur	badlapur
बदली	badal	badali
बदाम	badam	badam
बनवा	banva	banva
बनाम	banam	banaam
बनिया	baniya	baniya
बनू	banu	banu
बरपाया	barpaya	barpaya
बरसा	barsa	barsa
बरसाता	barsata	barsata
बरहद	barhad	barhad
बरात	barat	baraat
बरामद	barmad	baraamad
बरामदे	barmade	baramade
बरे	bare	bare
बर्थ	burth	birth
बलजीत	baljee	baljeet
बल्लभ	ballabh	ballabh
बल्ला	balla	balla
बल्ली	balli	balli
बसावा	basava	basava
बस्तियों	bastiyon	bastiyon
बहरूपिया	bahauopia	bahrupiya
बहामास	bahamas	bahamas
बहाव	bahav	bahaav
बहावलपुर	bahavalpur	bahavalpur
बहुचरा	bahuchrra	bahuchara
बांठिया	banthiya	banthiya
बांधते	bandhtee	bandhate
बांबी	banbi	banbi
बाउंसरों	bounsrroo	bounceron
बाउलिंग	bouling	bowling
बाकू	baku	baku
बाग	bag	baag
बागबानी	bagbann	bagbani
बागली	bagaii	bagli
बागियों	bagiyon	bagiyon
बागो	bago	bago
बाज़ी	bazi	bazi
बाजारू	bajarr	bajaru
बाजुओं	bajuon	bajuon
बाध	baahh	badh
बाधा	badha	badha
बाधाओं	badhaon	badhaon
बाधित	badhit	badhit
बानी	bani	bani
बापा	bapa	bapa
बाबत	babaa	baabat
बायर्न	bern	bayern
बारह	barah	barah
बारहमासी	barhamasi	barahmasi
बारहसिंगा	barhasinga	barahsinga
बाला	bala	bala
बाल्टी	balty	baalti
बाल्डविन	baldwin	baldvin
बावजी	bavaji	bavji
बावरा	bavaaa	baawaraa
बाहुल्य	bahulya	baahulya
बाॅक्स	box	box
बिखेरती	bikherati	bikherati
बिगेस्ट	bigesst	biggest
बिछुआ	bichhua	bichhuaa
बिजी	biji	biji
बिपिन	bipin	bipin
बिलाई	bilai	bilai
बिल्ला	billa	billa
बिल्हौर	bilhaur	bilhaur
बिस्वा	biswa	biswa
बीएजी	bgg	bag
बीकानेर	bikaner	bikaner
बीकानेरी	bikaneri	bikaneri
बीके	bike	bk
बीजक	bijak	bijak
बीफ	bief	beef
बीम	bie	bim
बीमों	bimon	bimon
बीरगंज	berggnj	birganj
बीसवां	bisaaan	beesavaan
बीस्ट	bist	beast
बुडविग	budvig	budwig
बुल	bul	bull
बुलाओ	bulao	bulao
बुले	bule	bule
बुलेटिन	bullatnn	bulletin
बृजेश	brijesh	brijesh
बेंवर	benwer	benwar
बेऔलाद	benlad	beaulad
बेकाबू	bekabu	bekabu
बेचकर	bechkar	bechakar
बेचते	bechtt	bechate
बेड़ियां	bediyan	bediyan
बेथनल	bethanal	bethnal
बेनिस	benis	benis
बेलचा	belcha	belacha
बेलिंडा	belinda	belinda
बेवकूफाना	bevauouaa	bevkufana
बेसहारा	besahara	besahara
बेसिन	basin	basin
बेसिल	basil	basil
बैंडेज	bandaeg	bandage
बैठते	baithate	baithate
बैतूल	battul	baitool
बैनी	banni	baini
बैरकपुर	bairakpur	barrackpore
बैला	baila	baila
बैलिस्टिक	balistiic	ballistic
बैल्स	balls	bells
बॉस्टन	bostan	bostan
बोकारो	bokaro	bokaro
बोदरा	bodra	bodra
बोना	bona	bona
बोरकर	borkar	borkar
बोरीवली	borivali	borivali
बोर्न	borr	born
बोलने	bolnn	bolane
बोलिए	boliye	boliae
बोसान	bosan	bosan
बौनी	bauni	bauni
ब्यावर	byaver	byavar
ब्रजेश	brajesh	brijesh
ब्रह्मलीन	brahmalin	brahmalin
ब्रावो	brawo	bravo
ब्रिगटन	brigttnn	brigatn
ब्रिगेडियर	brigadiar	brigadier
ब्रिटेन	briten	britain
ब्रीद	breed	breed
ब्रोक	broke	broke
ब्रोकन	brokan	broken
ब्लॉसम	blossmm	blossom
भगाने	bhagaan	bhagane
भड़काया	bhadakaya	bhadkaya
भभूत	bhabhot	bhabhut
भय	bhay	bhay
भयो	bhayo	bhayo
भरतनाट्यम्	bharatnatyam	bharatanatyam
भरते	bharae	bharte
भरनी	bharai	bharani
भरने	bharae	bharane
भरा	bhara	bhara
भविष्य	bhavishya	bhavishya
भाते	bhate	bhaate
भानू	bhanu	bhanu
भाबर	bhabar	bhabar
भारीय	bhariya	bhariy
भावनाओं	bhavnaon	bhavnaon
भास्कर	bhaskar	bhaskar
भीड़	bheed	bheed
भीरा	bhira	bhira
भीष्म	bhishm	bheesham
भुगत	bhugat	bhugat
भुगता	bhugtta	bhugta
भुट्टो	bhutto	bhutto
भुमि	bhumi	bhumi
भुरभुरा	bhurbuur	bhurbhura
भूख	bhukh	bhookh
भूखी	bhukhi	bhukhi
भूगोल	bhuool	bhugol
भूतल	bhutal	bhutal
भूपसिंह	bhupsingh	bhupsingh
भूमी	bhumi	bhumi
भूलता	bhulta	bhulta
भूला	bhula	bhula
भूली	bhuli	bhuli
भूलो	bhulo	bhulo
भूलों	bhulon	bhulon
भूसी	bhusi	bhusi
भूस्वामी	bhuswami	bhuswami
भेंगापन	bhengapan	bhengapan
भैरवनाथ	bhairaavaath	bhairavnath
भैरो	bhairo	bhairo
भोगते	bhogtt	bhogte
भोला	bhola	bhola
भोली	bholi	bholi
भोलू	bholu	bholu
भौंहों	bhaunoo	bhaunho
भ्रांत	bhrnnt	bhraant
भ्रांति	bhannti	bhraanti
भ्रांतियां	bhantiiyan	bhrantiyan
भ्रांतियों	bhanttiyon	bhrantiyon
मंगेश	mangesh	mangesh
मंच	manch	manch
मंचित	manchit	manchit
मंचीय	manchiya	mancheeye
मंचों	manchon	manchon
मंजिल	manjil	manjil
मंजिला	manjila	manjila
मंजिलें	manjilen	manjilein
मंटो	manto	manto
मंत्रियों	mantriyon	mantriyon
मकरानी	makraan	makrani
मक्सद	maksad	maksad
मखदुमपुर	makhadmuuu	makhdumpur
मचाए	machay	machae
मचानों	machanon	machanon
मढ़ौरा	madhouaa	madaura
मणिपाल	manipal	manipal
मतपत्रों	matpatron	matpatron
मत्थे	matthe	matthe
मत्स्यावतार	matsyyaaaar	matsyavatar
मत्स्येंद्रनाथ	matsyynnhanath	matsyendranath
मधुपुर	madhupur	madhupur
मनमर्जी	manamrji	manmarji
मनाए	manay	manae
मम	mam	mum
मयोर्का	mayorka	maryokar
मरदानी	mardani	mardani
मरमर	marmar	marmar
मराठा	maratha	maratha
मराठी	marathi	marathi
मर्जी	marji	marji
मर्दानगी	mardanngi	mardangi
मर्दों	mardon	mardon
मर्यादा	maryada	maryada
मर्यादाओं	maryadaon	maryadaon
मलागा	malaga	malaga
मलार	malar	malar
मशरक	mashrrk	mashrak
मसालेदार	masaledaa	masaledar
मसूर	masur	masoor
मस्से	masse	masse
महकने	mahkkne	mahakane
महलों	mahlon	mahalon
महाग्रंथ	mahagrantt	mahagranth
महाजन	mahajan	mahajan
महाथिर	mahathi	mahathir
महानतम	mahanata	mahanatam
महानिदेशक	mahanideshak	mahanideshak
महापौरों	mhhapuron	mahapauron
महाप्राण	mhaapran	mahapran
महामंत्र	mahamantra	mahamantr
महाराजा	maharaja	maharaja
महाविज्ञान	mahavigyan	mahavigyan
महाविद्या	mahavidya	mahavidya
महाविष्णु	mahavishun	mahavishnu
महासिंह	mahasingh	mahasingh
महिपाल	mahipal	mahipal
महीन	mahin	mahin
महीनों	mahinon	mahinon
मांग	mang	mang
मांगनी	mangani	mangni
मांगा	manga	manga
मांगी	manni	mangi
मांगे	mange	mange
मांगो	mango	mango
माओरी	maori	maori
माजिन	maajnn	majin
माथे	mathe	mathe
माप	maap	maap
मामूली	mamuli	mamuli
मामे	mame	mame
मारवाड़	marvad	maarvaad
मारिया	maaria	mariya
मारियो	maario	mariyo
मार्था	martha	martha
मालिश	malish	malish
मावे	mave	mave
मास	mass	maas
मासों	masonn	mason
मिटाओ	mitao	mitao
मिठाई	mithai	mithaai
मिडिया	midia	media
मिथिला	mithila	mithila
मिथिलांचल	mithilaacchal	mithilanchal
मिथ्या	mithya	mithya
मिमिक्री	mimmcry	mimicry
मिल्कियत	milkiyat	milkiyat
मिशा	misha	misha
मुंगेरी	mungeri	mungeri
मुंडवा	mundwa	mundwa
मुंशीगंज	munshiganj	munshiganj
मुकरते	mukarte	mukarte
मुखोपाध्याय	mukhopodhayy	mukhopadhyaya
मुख्यमंत्री	mukhyamantri	mukhyamantri
मुनाफ	munaf	munaf
मुनाफा	munafa	munafa
मुन्नू	munnu	munnu
मुफलिसी	mufaisi	muflisi
मुबारकपुर	mubarakpur	mubarakpur
मुर्झा	murjha	murjha
मुल्ताई	multai	multai
मुशाहिद	mushahid	mushahid
मुहावरे	muhavare	muhavare
मूठ	muth	mooth
मूड	mood	mood
मूडी	modi	moody
मूल	mul	mool
मूलचंद	mulcchand	moolchand
मूलर	muolar	moolar
मूलों	mulon	mulon
मेक्सिको	mexico	mexico
मेगा	mega	mega
मेगापिक्सल	megapicla	megapixel
मेजबान	mejbaan	mejbaan
मेजबानी	mejbaan	mejabani
मेज़बान	mejbban	mejbaan
मेज़बानी	mejabann	mejbaani
मेट	met	mate
मेट्स	mates	mates
मेडीकल	medical	medical
मेथेनॉल	methanol	methanol
मेनू	menu	menu
मेम	mame	mem
मेलघाट	melghat	melghat
मेलानिन	melanin	melanin
मेलानी	melani	melani
मेहमान	mehmaan	mehmaan
मेहराम	mehaaa	mehram
मैकबुक	macbuo	macbook
मैट्रिक्स	matrix	matrix
मैड	mad	made
मैडी	maddi	maidi
मैन	main	man
मैनन	maiaon	menon
मैनर	manner	manner
मैना	maina	maina
मैने	manne	maine
मैरेज	marrgg	marrej
मैसाचुसेट्स	massachusets	massachusetts
मैसोर	mesoor	maisor
मॉड	mod	mod
मॉडर्न	moderrn	modern
मॉड्यूल	moduue	module
मॉड्यूल्स	moduol	modules
मॉरिशस	mauritius	mauritius
मोगली	mogal	mowgli
मोटिव	motive	motive
मोल	mol	mol
मोल्ड	mold	mold
मोशे	moshe	moshe
मोसाद	mosad	mosad
मोहाना	mohana	mohana
मोहानी	mohani	mohani
मोहिनी	mohini	mohini
मोहिम	mohim	mohim
मौकों	maukon	maukon
मौमा	mauma	mauma
मौर्या	maurya	maurya
मौर्यों	mauryon	maurya
मौलवियों	mauliviyon	maulaviyon
मौले	maule	maule
मौसा	mausa	mausa
यत्न	yatna	yatn
यदा	yada	yada
यदुवंश	yaduvansh	yaduvansh
यरूशलेम	yaruchele	jerusalem
यशपाल	yashpal	yashpal
यातना	yatnaa	yatna
यातनाओं	yataaoo	yatnaon
यात्राएं	yatraeen	yarayan
यारियां	yarryyan	yaariyan
यारी	yari	yaari
युग्म	yugm	yugam
युद्धरत	yuddhaat	yudhrat
यूक्रेनियन	ukrrinian	ukrainian
येरुशलम	yerushalam	jerusalem
यॉर्कर	yorker	yorker
योजनाएं	yojanayn	yojanaein
रंगते	rangae	rangate
रंजकता	ranjkkta	rangkata
रईस	ris	raees
रक्ताभ	raktabh	raktabh
रखना	rakhna	rakhna
रघुपति	raghupati	raghupati
रघुराम	raghuram	raghuram
रजिस्टर्ड	registerd	registered
रतनपुर	ratanpur	ratanpur
रनर्स	runners	runners
रयान	rayan	ryan
रल्हन	ralhan	ralhan
रविश	ravish	ravish
रवैल	ravail	ravel
रसद	rasad	rasad
रसायनिक	rasaayiii	rasaayanik
रसायनों	rasayaoon	rasaayanon
रहमत	rahmat	rahamat
रहेंगे	rahenge	rahenge
रहेगी	rahegi	rahegi
राउंडर	rounder	rounder
राक	rak	rak
राखे	rakhe	rakhe
रागों	ragon	raagon
राघवन	raghhan	raghavan
राज	raj	raj
राजकोट	rajcot	rajkot
राजतंत्र	rajattnra	rajtantra
राजनीतीकरण	rajneiikaaan	raajneetikaran
राजमां	rajman	rajma
राजस्व	rajssv	rajasva
राजी	raji	raji
राजीनामा	rajinaaa	rajinama
राजों	rajon	rajon
राणा	rana	rana
रात्रिचर	ratrithor	ratrichar
राधे	radhe	radhe
रानापुर	ranapur	ranapur
राबिन	rabin	rabin
राभा	rabha	rabha
रामकोट	ramkot	ramkot
रामटेक	ramtek	ramtek
रामपुर	rampur	rampur
रामभरोसे	rambhurese	rambharose
रामराज	ramraj	ramraj
रालोद	ralod	raalod
रावले	ravle	ravle
रासायनिक	rasaayyii	rasayanik
रिक्रिएशन	recrition	recreation
रिग	rig	rig
रिग्स	rigs	rigs
रिचुअल	richul	ritual
रिडक्शन	redection	reduction
रिपन	repon	ripan
रिया	riya	riya
रिश्ते	rishte	rishte
रिसने	resann	risane
रिहाना	rihana	rihana
रीगल	reagle	regal
रीजनल	reesnnll	regional
रीट्वीट	retvvet	retweet
रीता	rett	reeta
रुकते	ruktt	rukte
रुग्ण	rogna	rugna
रुग्णता	ruggnta	rugnata
रुजवेल्ट	ruojevelt	rojvelt
रुडोल्फ	rudoof	rudolf
रुपेश	rupess	rupesh
रुबी	rubi	ruby
रुमानी	rumani	rumani
रूकावटों	rukavaton	rukavaton
रूट	rot	root
रूटिंग	ruting	rooting
रूट्स	ruts	roots
रूपक	ropak	roopak
रूपी	ropi	rupi
रेंटल	rental	rental
रेगिस्तान	registan	registan
रेगिस्तानी	registani	registani
रेजा	reja	reja
रेट	ret	rate
रेत	ret	ret
रेफेली	refeli	refaeli
रेशे	reshe	reshe
रेस	res	race
रेसर	resor	racer
रेसिंग	racsing	racing
रेसों	resoon	reson
रेहाना	rehana	rehana
रैकेटियर	racketiar	racketeer
रैडिकल	radical	radical
रैथ	rathh	raith
रैपिंग	rappnng	rapping
रॉबर्टसन	roberteoan	robertson
रॉबिंसन	robinsoon	robinson
रॉयल्स	royles	royals
रोजलिन	rojlin	rojlin
रोटेशन	rotation	rotation
रोड्रिगो	rodrigon	rodrigo
रोनाल्डो	ronaldo	ronaldo
रोनित	ronit	ronit
रोनी	roni	roni
रोपने	ropnn	ropane
रोबिन	robin	robin
रोया	roya	roya
रोलर्स	rolers	rollers
रोवन	rovan	rowan
रोसारियो	rosarioo	rosariyo
रौबदार	rabbadar	raubdar
लंगड़ा	langada	langada
लंगर	langer	langar
लंगरों	langaron	langaron
लंबी	lambi	lambi
लकीर	laceer	lakir
लकीरों	laciron	lakiron
लक्मे	lakme	lakme
लक्ष्मीधर	lakshmidhar	lakshmidhar
लक्ष्य	lakshya	lakshy
लक्ष्यों	lakshyon	lakshyon
लक्स	lax	lux
लक्सर	laxoar	laksar
लख्खी	lakhki	lakhkhi
लगना	lagna	lagna
लगनेवाले	lagneewae	laganewale
लगेगा	lagega	lagega
लज्जालु	lajjalu	lajjalu
लटकाते	latkatt	latkate
लड़की	ladki	ladki
लड़ते	ladte	ladte
लड़ाई	ladai	ladai
लड़ाईयों	ladaiyon	ladaiyon
लपेटने	lapetaee	lapetane
लबादा	labada	labada
लब्ध	labdh	labdh
ललक	lalak	lalak
ललकारता	lalkarata	lalkarta
लल्ला	lalla	lalla
लवासा	lavasa	lavasa
लस्सी	lassi	lassi
लहना	lahna	lahanaa
लहराई	lahrai	lahrai
लहलहाती	lahlahati	lahlahati
लहसुन	lahsun	lahsun
लांचर	lancher	launcher
लाइकोपिन	licopine	lycopene
लाइम	lime	lime
लाइव्स	lives	lives
लाईव	live	live
लाएगी	lagygi	laegi
लागातार	lagatta	lagatar
लाता	lata	laata
लाती	latt	laati
लायेगा	layega	layega
लालपुर	lalpur	lalpur
लास्ट	last	last
लिंगभेद	lingbbad	lingbhed
लिंडन	lindon	lindan
लिखकर	likhaaa	likhakar
लिगर	liger	ligar
लिबरेशन	liberation	liberation
लिब्रेशन	libertion	liberation
लीडरों	leddron	leaderon
लुईस	loos	luis
लुढ़कते	ludhkatt	ludhakate
लुत्फ	lutt	lutf
लुमडिंग	lumding	lumding
लूटमार	lootmr	lootmaar
लेंडल	lendal	lendal
लेगा	lega	lega
लेटकर	latkkr	letkar
लेनेवाली	lenewali	lenewali
लेबल	lable	label
लेबलिंग	labllnng	labeling
लेबलों	lablon	labelo
लेमन	leman	lemon
लैंगडन	langdon	laingadan
लैंगिकता	langikata	laingikta
लैंसेट	lanset	lenset
लैरी	larry	lairi
लैस	las	less
लॉकेट	locket	locket
लॉन्ड्री	launder	laundry
लोंगोवाल	longowal	longewal
लोग	log	log
लोगे	loge	loge
लोचदार	lochaaa	lochdar
लोदी	lodi	lodi
लौरेंस	laurence	laurence
वंडर	wonder	wonder
वंश	vansh	vansh
वंशधर	vanshdhar	vanshdhar
वंशवाद	vanshvad	vanshvad
वजूद	vajood	vajud
वडाली	vadali	wadali
वनिता	vanita	vanita
वरेण्य	varenya	varenya
वर्ण	varn	varn
वर्णित	varnit	varnit
वर्तमान	vartmaa	vartaman
वर्द्धमान	varddhman	varddhaman
वर्बल	worbee	verbal
वर्शन	varshon	version
वर्साचे	varsache	varsaache
वल्कन	valkan	valkan
वश	vash	vash
वशीकरण	vashikaran	vashikaran
वांगचुक	vanghhhu	vaangchuk
वांट	want	want
वाइज	vije	vije
वाटर	watter	water
वाटसन	vatasan	watson
वाण	wan	vaan
वाणों	vanon	vaanon
वातानुकूलन	vatanukulan	vatanukulan
वादक	vadak	vadak
वादियों	vaddyon	vaadiyon
वायना	vayna	vayana
वायरलेस	wirele	wireless
वारियर्स	warirors	warriors
वाल्व	valv	valve
वास्तविक	vastavik	vastvik
वाहिकाएं	wahikaeen	vahikayen
विंटर	winter	winter
विंसेंट	winsent	vincent
विकल्पों	vikalpon	vikalpon
विकेट	wicket	wicket
विक्रमजीत	vikramajet	vikramjeet
विचारकों	vicharaoon	vicharakon
विज्ञान	vigyan	vigyan
विज्ञानी	vigyani	vigyani
विज्ञानों	vigyanon	vigyanon
विट्ठल	vitthal	vitthal
विठ्ठल	vithhal	viththal
वितर्क	vitark	vitark
विद्याएं	vidhayen	vidhaaein
विद्याओं	vidhaon	vidhaaon
विधानसभाएं	vidhansabhaenn	vidhansabhaen
विधिवत	vidhivat	vidhivat
विधुत	vidhut	vidhut
विनष्ट	vinshh	vinasht
विनीत	vinit	vineet
विपरीतता	vipriitaaa	vipritata
विप्रा	vipra	vipra
विप्रो	vipro	wipro
विभा	vibha	vibha
विभाजक	vibhajak	vibhajak
विभ्रम	vibharm	vibhram
विमर्श	vimersh	vimarsh
विमर्शों	vimarshon	vimarshon
विराजती	virajati	virajati
विरेचन	virechan	virechan
विरोध	virodh	virodh
विरोधाभासी	virodhabaasi	virodhabhasi
विरोधाभासों	virodhabhason	virodhabhason
विविध	vividh	vividh
विवेकहीन	vivechhee	vivekheen
विशेषण	visheshan	visheshan
विशेषणों	visheshanon	visheshanon
विशेषाधिकार	visheshadhikar	visheshadhikar
विश्वसनीय	vishwasanyyy	vishwasaniy
विश्वसनीयता	vishwasaniyta	vishwasaniyata
विषहीन	vishahin	vishhin
विष्णु	vishau	vishnu
वीएलसी	vsc	vlc
वीक्स	wix	weeks
वीरचंद	verrcaadd	veerchand
वीरेश	viresh	viresh
वृत्तों	vritton	vritton
वेंकटरमन	venkatraaan	venkatraman
वेड	wed	ved
वेडिंग	wedding	wedding
वेदियों	vediyon	vediyon
वेदों	vedon	vedon
वेनेजुएला	venegula	venezuela
वेरोनिका	veronica	veronica
वेलवेट	velvett	velvet
वेल्डर	welder	weldor
वेल्डिंग	welding	welding
वेल्थ	velth	wealth
वेल्लूर	velluoe	vellur
वेश	vesh	vesh
वेस्टिंग	westing	wasting
वेस्टिंगहाउस	westinggasuu	westinghouse
वेस्ले	wesle	vaisley
वैज्ञानिक	vaijyanik	vaigyanik
वैज्ञानिकता	vaijyanikata	vaigyaanikta
वैत्रवती	vaitravati	vaitravati
वैमनस्य	vaimansaa	vaimanasy
वैरी	vairy	very
वैशाख	vaishak	vaishakh
वैशाखी	vaishakh	vaishakhi
वैष्णोदेवी	vasshnndvvd	vaishnodevi
व्यक्तिगत	vyaktigat	vyaktigat
व्यग्र	vyagra	vyagra
व्यतीत	vyatet	vyatit
व्यभिचार	vyabhhcha	vyabhichar
व्यवधान	vyavahhan	vyavdhan
व्यवहारगत	vyavaharaat	vyavahargat
व्याघात	vyaghat	vyaghat
व्यापक	vyapak	vyapak
व्लाद	wlaa	vlad
व्लादिमीर	vladimir	vladimir
शंघाई	shanghai	shanghai
शतपथ	shatpath	shatpath
शनिवार	shanivar	shanivar
शबाना	shabana	shabana
शब्दार्थ	shabdarth	shabdarth
शमादान	shamadan	shmadan
शमिताभ	shamitabh	shamitabh
शमिल	shamil	shamil
शराबों	sharabon	sharabon
शरारत	shararat	shararat
शर्माना	sharmana	sharmana
शहरवासियों	sheharvasiyon	shaharwasiyon
शहादरा	shahadaa	shahdara
शांतिकाल	shantikal	shantikal
शाओ	shao	shao
शाकिर	shakkr	shaakir
शाखाएं	shakkhaenn	shaakhaaen
शायक	shayak	shayak
शावकों	shaaaaoon	shaavakon
शासक	shasak	shasak
शासकों	shasakoon	shasakon
शिप्रा	shipra	shipra
शिर्के	shirke	shirke
शीर्षकों	shirshhaoon	sheershakon
शुजात	shujat	shujat
शुटिंग	shutting	shooting
शुड	shud	shud
शुभंकर	shubhankar	shubhankar
शुमाली	shumali	shumali
शृंगार	shringar	shringaar
शेलिंग	shaling	shelling
शैली	shaili	shaili
शैशव	shaishav	shaishav
शॉन	shon	shaun
शोर्ट	short	short
श्योर	shror	sure
श्रंखला	shrankhala	shrankhala
श्रंखलाओं	shrankhalaon	shrankhalaaon
श्रावणी	shravani	shravani
श्रीकर	shrikar	shrikar
श्रीखंड	shrikhand	shrikhand
श्रीमति	shrimati	shrimati
श्रीराम	shriaam	shriram
श्रोताओं	shrttaon	shrotaon
षट्	shat	shat
संख्याएं	sankhyyeen	sankhyaein
संघनित	sanghantt	sanghanit
संचयन	sanchayan	sanchayan
संचार	sanchar	sanchar
संचारी	sanchari	sanchari
संचालनों	sanchalaaon	sanchalnon
संजय	sanjay	sanjay
संजीवन	sanjeevan	sanjivan
संतति	santati	santati
संदर्भ	sandarbh	sandarbh
संदर्भों	sandarbhon	sandrbhon
संदली	sandali	sandali
संधान	sandhan	sandhan
संप्रति	samprati	samprati
संप्रभु	samprbhu	samprabhu
संप्रभुता	sampaabuuta	samprabhuta
संबित	sambit	sambit
संभालने	sambhalaee	sambhalne
संभ्रांत	sambharnt	sambhrant
संयुक्त	sanyukt	sanyukt
संयुक्ता	sanyukta	sanyukta
संयोगवश	sanyogash	sanyogvash
संयोजन	sanyojan	sanyojan
संयोजनों	sanyojanon	sanyojanon
संवेदीकरण	samvedikaran	sanvedikaran
संशयों	sanshyoon	samshayon
संस्कार	sanskar	sanskar
संस्कारी	sanskari	sanskari
संस्कृत	sanskrut	sanskrit
संस्कृतियां	sanskritiyan	sanskritiyan
संस्कृतियों	sanskritiyon	sanskritiyon
संस्थित	sansthit	sansthit
संस्थिता	sansthita	sansthita
सकरा	sakra	sakra
सक्शन	sakshan	suction
सच्चिदानंद	sachciianand	sacchidanand
सज्जा	sajja	sajja
सत	sat	sat
सतपाल	satpal	satpal
सतलुज	satauj	satluj
सताने	sataan	satane
सते	sate	sate
सत्ती	satti	satti
सत्वत	satvat	satvat
सदानंद	sadanand	sadanand
सपने	sapne	sapane
सपरिवार	sapaiiaa	saparivaar
सपाट	sapat	sapat
सपाटे	sapate	sapate
सप्तक्रांति	saptaktanti	saptakranti
सप्तपदी	saptapaii	saptapadi
सप्तरी	saptari	saptari
सप्रमाण	sapraman	sapraman
सबमिट	submit	submit
सबमिशन	sabmishin	submission
सभाएं	sabhayen	sabhaein
सभासदों	sabhasadon	sabhasadon
सभ्यता	sabhyata	sabhyata
समझूंगा	samjhoong	samjhunga
समन	saman	saman
समन्वयक	samanvayak	samanvayaka
समाधान	samadhan	samadhan
समाधियों	samadhiyon	samadhiyon
समालखा	samalkha	samalakha
समाहार	samahar	samahar
समितियां	samitiyan	samitiyan
समेटती	sametati	sametati
सरका	sarka	sarka
सरकारें	sarkaren	sarkaren
सरकारों	sarkaron	sarkaron
सरगना	sargana	sargana
सरगनाओं	sarganaon	sarganaon
सरगी	sargi	sargi
सरगुजा	sarguja	sarguja
सरसा	sarsa	sarsa
सरहिंद	sarhind	sarahind
सराहा	saraha	saraha
सराही	sarahi	sarahi
सलाहकार	salahkka	salaahkar
सलीब	salib	salib
सलेक्ट	salect	select
सल्तनत	saltantt	saltanat
सवाल	sawal	sawal
सहकलाकार	sahakklaaar	sahkalakar
सहदेव	sahdev	sahdev
सहरावत	saharaaa	sahrawat
सहूलियत	sahuliyat	sahuliyat
सांकेतिक	sanketik	sanketik
साइमंस	scmens	saimans
साइमा	sima	saima
सागरिका	sagrrkka	sagarika
सागा	saga	saga
साजन	saaann	sajan
साजसज्जा	sajssjja	saajsajja
साजा	saja	saja
साथसाथ	sathaatth	saathsaath
साथिया	sathiya	sathiya
साबाह	sabah	sabah
सामंजस्य	samansayy	samanjasya
सामोआ	samoa	samoa
सायं	sayan	saayn
सायरा	syyra	sayara
साल्वे	salve	salve
साहब	sahaa	sahab
सिंगापुर	singapur	singapore
सिंगार	singar	singaar
सिंघाड़े	singhade	singhaadey
सिंघी	singhi	singhi
सिंहा	sinha	sinha
सिएरा	siraa	sierra
सिकुड़	sikud	sikud
सिगनल्स	signans	signals
सिगरेटों	sigeraton	cigaretton
सिद्धवट	siddhaaa	siddhivat
सिनाबंग	sinabang	sinabang
सिनेप्स	cyneps	synapse
सिपाह	sipah	sipah
सिपाहियों	sipahiyon	sipahiyon
सिपाही	sipahi	sipahi
सिम	sim	sim
सिमट	simat	simat
सिमटता	simatta	simatataa
सिमटे	simtt	simate
सिमी	simi	simi
सिम्स	simss	sims
सियासी	siaasi	siyasi
सियाह	siaah	siyah
सिरपुर	sirpur	sirpur
सिवान	sivan	siwan
सिसवा	siswa	siswa
सीआईएल	cil	cil
सीएसआई	csi	csi
सीकर	sicar	sikar
सीटें	seaten	seaten
सीताराम	sitaram	sitaram
सीताहरण	sitaharan	sitaharan
सीपीएम	cpm	cpm
सीपीएस	cps	cps
सीबीएसई	cbs	cbse
सीम	seem	sim
सील्ड	sell	sealed
सीसीडी	ccd	ccd
सुगमता	sugmata	sugamata
सुजेन	sujen	sujan
सुजैन	sujain	sujain
सुझाती	sujhati	sujhati
सुतली	sutali	sutali
सुता	suta	suta
सुदीप	sudip	sudip
सुधारगृह	sudhararrah	sudhaargrah
सुनारों	sunaron	sunaron
सुनासीर	sunasier	sunaseer
सुनीति	suniti	suniti
सुनेगा	sunega	sunega
सुपरहिट	superhit	superhit
सुपाच्य	supachya	supachy
सुभाय	subhaya	subhay
सुरवीन	surveen	survin
सुराणा	surana	surana
सुलखान	sulkhan	sulkhan
सुलझाई	suljhai	suljaayi
सुलताना	sultana	sultana
सुलाती	sulati	sulati
सुसंस्कृत	susankrit	susanskrit
सुहागिन	suhagin	suhagin
सूंड़	sund	sund
सूइयां	suiyan	suiyan
सूखती	sukhati	sukhti
सूखाकर	sukhakar	sukhakar
सूचक	suchak	suchak
सूजा	suja	sooja
सूबा	suba	suba
सूबे	subey	sube
सूरज	suraj	suraj
सूरीनाम	surinaa	surinaam
सूर्यदेव	suryadev	suryadev
सेंधा	sendha	sendha
सेंवई	senvai	senvai
सेंसिंग	sensing	sensing
सेक्सुअल	sexuu	sexual
सेटरडे	stterad	saturday
सेटी	sati	seti
सेटो	seto	seto
सेथ	seth	seth
सेफ्टी	sefty	safety
सेमिन	semin	semin
सेल्फ	self	self
सेल्फी	selfiy	selfie
सेव	save	save
सेवकों	sevaoon	sevakon
सैम्युल्स	sammuls	samuels
सैलरी	sailery	salary
सॉकर	socar	sakar
सॉन्ग्स	sonnss	songs
सॉलिसिटर	solicitor	solicitor
सोचने	sochnn	sochane
सोनू	sonu	sonu
सोमा	soma	soma
सोमी	somi	somi
सोय	soy	soy
सोया	soya	soya
सोलिटेयर	solitiror	solitaire
सोहराई	sohrai	sohrai
सोहावल	sohawal	sohawal
सौंपने	sounpne	saunpane
स्काला	skala	scala
स्की	skee	ski
स्कूटरों	skoturon	scootaron
स्कैंडिनेविया	scandineviaa	scandinavia
स्कैनिंग	scanning	scanning
स्क्वाश	squash	squash
स्क्वैश	squssh	squash
स्खलन	skhalan	skhalan
स्टैन	stan	stan
स्टॉप	stop	stop
स्टॉप्स	stops	stops
स्टोन	stone	stone
स्ट्रास	strass	straws
स्ट्रे	streye	stra
स्ट्रोक्स	strox	strokes
स्तन	stan	stan
स्तनधारी	standhari	standhari
स्तिथि	stithi	stithi
स्तुति	stuti	stuti
स्थितियां	sthitiyan	sthitiyan
स्थितियों	sthitiyon	sthitiyon
स्थूल	sthuo	sthul
स्थूलता	sthuolaa	sthulata
स्नीकर्स	snicers	sneakers
स्पीयर	spear	spear
स्पेल	spail	spell
स्पेलर	spailar	speller
स्प्रिट	sprit	sprit
स्प्रे	sprey	spray
स्फूर्ति	sfhuorti	sfoorti
स्लाइड	slyde	slide
स्लाइडर	slyder	slider
स्लाइडों	slydon	slidon
स्लाइड्स	slyds	slides
स्लाइस	slice	slice
स्लैश	slash	slash
स्वरुपों	swarupon	swarupon
स्वा	swa	swa
स्वाचालित	swachalit	swachalit
स्वार्थपरक	swarthaaaak	swarthparak
स्विफ्टलेट	swiftalet	swiftlet
स्वीकारते	swikartt	swikarte
स्वीट	sweet	sweet
स्वीप	sweep	sweep
स्वेच्छा	sweccha	sweccha
स्वेता	sweta	sweta
स्वैप	swap	swap
हंडिया	handia	handiya
हकीकत	hakikat	hakikat
हथिया	hathiya	hathiya
हमला	humla	hamla
हमलावर	humlavar	hamalavar
हमाल	hamal	hamaal
हरक्यूलिस	harculis	hercules
हरदास	hardas	hardas
हरपाल	harpal	harpal
हरवंश	harvansh	harvansh
हरावल	harawal	harawal
हरिकेन	hariken	hurricane
हरिजन	harijan	harijan
हरियाली	hariyali	hariyali
हर्षित	harshit	harshit
हल्दी	haldi	haldi
हल्ला	halla	halla
हवामहल	hawammaa	hawamahal
हवालात	hawalat	hawalat
हसीनों	hasinon	hasinon
हां	han	han
हांफते	hanfate	haanfte
हाइमन	himeon	hymen
हाड़ौती	hadauti	hadauti
हानी	hani	hani
हारजीत	harjeet	haarjeet
हारना	harna	harna
हालचाल	halchal	haalchaal
हाल्ट	halt	halt
हाहाकार	hahakar	hahakar
हिंगिस	hingis	hingis
हिंडन	hindon	hindan
हिजड़ा	hijda	hijada
हिजबुल	hijbul	hijbul
हिप्पो	hippo	hippo
हिप्पोपोटेमस	hippotopess	hippopotamus
हिमाली	himali	himali
हिलने	hilaee	hilne
हिशाम	hisham	hisham
हीरागंज	hiraganj	hiraganj
हीरोज	heroj	heroes
हुईं	huain	huin
हूपर	huper	hooper
हेगडे	hegdey	hegde
हेमवती	hemawti	hemwati
हेल्प	help	help
हेल्पर	helper	helper
हैतो	haito	haito
हैरम	harra	hairam
हैराल्ड	harrald	herald
हैव	haiv	have
हॉन्ग	hong	hong
हॉफ	hoff	half
होऊंगा	hooonga	hounga
होल्डिंग	holding	holding
होशंगाबाद	hoshanbabad	hoshangabad
होस्टेस	hostets	hostess
